,Year,Period,labor force participation rate,employment-population ratio,labor force,employment,unemployment,unemployment rate,State
0,2005,Jan,64.1,61.2,2813887,2684510,129377,4.6,AZ
1,2005,Feb,64.1,61.1,2821319,2690651,130668,4.6,AZ
2,2005,Mar,64.1,61.1,2830147,2698108,132039,4.7,AZ
3,2005,Apr,64.1,61.1,2840229,2707135,133094,4.7,AZ
4,2005,May,64.2,61.2,2850925,2717283,133642,4.7,AZ
5,2005,Jun,64.2,61.2,2861177,2727304,133873,4.7,AZ
6,2005,Jul,64.2,61.2,2870449,2736262,134187,4.7,AZ
7,2005,Aug,64.2,61.2,2878393,2743723,134670,4.7,AZ
8,2005,Sep,64.1,61.1,2885335,2750192,135143,4.7,AZ
9,2005,Oct,64.0,61.0,2892105,2757019,135086,4.7,AZ
10,2005,Nov,64.0,61.0,2899289,2765037,134252,4.6,AZ
11,2005,Dec,63.9,61.0,2907204,2774501,132703,4.6,AZ
12,2006,Jan,63.9,61.1,2916314,2785456,130858,4.5,AZ
13,2006,Feb,64.0,61.1,2926379,2796970,129409,4.4,AZ
14,2006,Mar,64.0,61.2,2937047,2808195,128852,4.4,AZ
15,2006,Apr,64.1,61.3,2947857,2818660,129197,4.4,AZ
16,2006,May,64.1,61.3,2958210,2828396,129814,4.4,AZ
17,2006,Jun,64.2,61.3,2967768,2837632,130136,4.4,AZ
18,2006,Jul,64.2,61.4,2977028,2847274,129754,4.4,AZ
19,2006,Aug,64.2,61.5,2986508,2857798,128710,4.3,AZ
20,2006,Sep,64.3,61.5,2995813,2868713,127100,4.2,AZ
21,2006,Oct,64.3,61.6,3004252,2879213,125039,4.2,AZ
22,2006,Nov,64.3,61.7,3011163,2888274,122889,4.1,AZ
23,2006,Dec,64.2,61.7,3015741,2894953,120788,4.0,AZ
24,2007,Jan,64.1,61.6,3017695,2899008,118687,3.9,AZ
25,2007,Feb,64.0,61.5,3017647,2901286,116361,3.9,AZ
26,2007,Mar,63.8,61.4,3015955,2902281,113674,3.8,AZ
27,2007,Apr,63.6,61.3,3013261,2902557,110704,3.7,AZ
28,2007,May,63.4,61.2,3010820,2902959,107861,3.6,AZ
29,2007,Jun,63.3,61.1,3009749,2904001,105748,3.5,AZ
30,2007,Jul,63.2,60.9,3010496,2905303,105193,3.5,AZ
31,2007,Aug,63.1,60.9,3013553,2906699,106854,3.5,AZ
32,2007,Sep,63.1,60.8,3018977,2908422,110555,3.7,AZ
33,2007,Oct,63.1,60.7,3026157,2910471,115686,3.8,AZ
34,2007,Nov,63.1,60.6,3033968,2912955,121013,4.0,AZ
35,2007,Dec,63.2,60.6,3041613,2915755,125858,4.1,AZ
36,2008,Jan,63.2,60.5,3048650,2918156,130494,4.3,AZ
37,2008,Feb,63.2,60.4,3055250,2919912,135338,4.4,AZ
38,2008,Mar,63.3,60.4,3062260,2920981,141279,4.6,AZ
39,2008,Apr,63.3,60.3,3070618,2921370,149248,4.9,AZ
40,2008,May,63.4,60.1,3080677,2921270,159407,5.2,AZ
41,2008,Jun,63.5,60.0,3092028,2921092,170936,5.5,AZ
42,2008,Jul,63.7,59.9,3103708,2920905,182803,5.9,AZ
43,2008,Aug,63.8,59.8,3114501,2920241,194260,6.2,AZ
44,2008,Sep,63.9,59.7,3123387,2917994,205393,6.6,AZ
45,2008,Oct,63.9,59.5,3129730,2912892,216838,6.9,AZ
46,2008,Nov,63.9,59.2,3133420,2904315,229105,7.3,AZ
47,2008,Dec,63.9,58.9,3135110,2892889,242221,7.7,AZ
48,2009,Jan,63.8,58.6,3135245,2879700,255545,8.2,AZ
49,2009,Feb,63.7,58.2,3134718,2866239,268479,8.6,AZ
50,2009,Mar,63.6,57.9,3134761,2854602,280159,8.9,AZ
51,2009,Apr,63.5,57.7,3135697,2845709,289988,9.2,AZ
52,2009,May,63.5,57.4,3136601,2838286,298315,9.5,AZ
53,2009,Jun,63.4,57.2,3136757,2831102,305655,9.7,AZ
54,2009,Jul,63.3,57.0,3135266,2823229,312037,10.0,AZ
55,2009,Aug,63.1,56.7,3131513,2814158,317355,10.1,AZ
56,2009,Sep,62.9,56.5,3126346,2804614,321732,10.3,AZ
57,2009,Oct,62.7,56.2,3120895,2795851,325044,10.4,AZ
58,2009,Nov,62.6,56.0,3116842,2789383,327459,10.5,AZ
59,2009,Dec,62.5,55.9,3115241,2785895,329346,10.6,AZ
60,2010,Jan,62.4,55.8,3115797,2785351,330446,10.6,AZ
61,2010,Feb,62.3,55.7,3116749,2786396,330353,10.6,AZ
62,2010,Mar,62.3,55.7,3116147,2787165,328982,10.6,AZ
63,2010,Apr,64.3,57.6,3113354,2786810,326544,10.5,AZ
64,2010,May,64.2,57.5,3108504,2785501,323003,10.4,AZ
65,2010,Jun,64.0,57.4,3102036,2782917,319119,10.3,AZ
66,2010,Jul,63.7,57.2,3094880,2779038,315842,10.2,AZ
67,2010,Aug,63.5,57.1,3088178,2774664,313514,10.2,AZ
68,2010,Sep,63.3,56.9,3082127,2770279,311848,10.1,AZ
69,2010,Oct,63.1,56.7,3076852,2766599,310253,10.1,AZ
70,2010,Nov,62.9,56.6,3072209,2763909,308300,10.0,AZ
71,2010,Dec,62.8,56.5,3067605,2762374,305231,10.0,AZ
72,2011,Jan,62.6,56.4,3063471,2761928,301543,9.8,AZ
73,2011,Feb,62.5,56.4,3060176,2761805,298371,9.8,AZ
74,2011,Mar,62.3,56.3,3057262,2761339,295923,9.7,AZ
75,2011,Apr,62.2,56.2,3054212,2760059,294153,9.6,AZ
76,2011,May,62.1,56.1,3051429,2758301,293128,9.6,AZ
77,2011,Jun,62.0,56.0,3049264,2757097,292167,9.6,AZ
78,2011,Jul,61.9,56.0,3047928,2757526,290402,9.5,AZ
79,2011,Aug,61.8,55.9,3047345,2759876,287469,9.4,AZ
80,2011,Sep,61.7,55.9,3047212,2763942,283270,9.3,AZ
81,2011,Oct,61.6,55.9,3047502,2769137,278365,9.1,AZ
82,2011,Nov,61.5,56.0,3047623,2774329,273294,9.0,AZ
83,2011,Dec,61.4,56.0,3047727,2778825,268902,8.8,AZ
84,2012,Jan,61.3,56.0,3048161,2782738,265423,8.7,AZ
85,2012,Feb,61.3,56.0,3048882,2786310,262572,8.6,AZ
86,2012,Mar,61.2,56.0,3050044,2789251,260793,8.6,AZ
87,2012,Apr,61.2,56.0,3051345,2791656,259689,8.5,AZ
88,2012,May,61.1,55.9,3052719,2794227,258492,8.5,AZ
89,2012,Jun,61.0,55.9,3054066,2797416,256650,8.4,AZ
90,2012,Jul,61.0,55.9,3055366,2801303,254063,8.3,AZ
91,2012,Aug,60.9,55.9,3056822,2805561,251261,8.2,AZ
92,2012,Sep,60.9,55.9,3058702,2809750,248952,8.1,AZ
93,2012,Oct,60.8,55.9,3060209,2812844,247365,8.1,AZ
94,2012,Nov,60.8,55.9,3060910,2814217,246693,8.1,AZ
95,2012,Dec,60.7,55.8,3060362,2813704,246658,8.1,AZ
96,2013,Jan,60.6,55.7,3058620,2811785,246835,8.1,AZ
97,2013,Feb,60.5,55.6,3056893,2810201,246692,8.1,AZ
98,2013,Mar,60.4,55.5,3056334,2810619,245715,8.0,AZ
99,2013,Apr,60.3,55.5,3057784,2813639,244145,8.0,AZ
100,2013,May,60.3,55.5,3060694,2818192,242502,7.9,AZ
101,2013,Jun,60.3,55.6,3064094,2822985,241109,7.9,AZ
102,2013,Jul,60.3,55.6,3067255,2827358,239897,7.8,AZ
103,2013,Aug,60.2,55.6,3069196,2831079,238117,7.8,AZ
104,2013,Sep,60.2,55.5,3069703,2834283,235420,7.7,AZ
105,2013,Oct,60.1,55.5,3070375,2837884,232491,7.6,AZ
106,2013,Nov,60.0,55.5,3072551,2843115,229436,7.5,AZ
107,2013,Dec,60.0,55.6,3076382,2850146,226236,7.4,AZ
108,2014,Jan,60.0,55.7,3081484,2858474,223010,7.2,AZ
109,2014,Feb,60.0,55.8,3087246,2867319,219927,7.1,AZ
110,2014,Mar,60.1,55.8,3093246,2875911,217335,7.0,AZ
111,2014,Apr,60.1,55.9,3098896,2883663,215233,6.9,AZ
112,2014,May,60.1,56.0,3104438,2891087,213351,6.9,AZ
113,2014,Jun,60.1,56.1,3110915,2899220,211695,6.8,AZ
114,2014,Jul,60.2,56.1,3118643,2908222,210421,6.7,AZ
115,2014,Aug,60.3,56.2,3127937,2918301,209636,6.7,AZ
116,2014,Sep,60.4,56.3,3138216,2929099,209117,6.7,AZ
117,2014,Oct,60.4,56.4,3147375,2939396,207979,6.6,AZ
118,2014,Nov,60.5,56.5,3153926,2947951,205975,6.5,AZ
119,2014,Dec,60.5,56.6,3158664,2954989,203675,6.4,AZ
120,2015,Jan,60.4,56.6,3162393,2961081,201312,6.4,AZ
121,2015,Feb,60.4,56.6,3165741,2966433,199308,6.3,AZ
122,2015,Mar,60.4,56.6,3169469,2971786,197683,6.2,AZ
123,2015,Apr,60.4,56.7,3174046,2977647,196399,6.2,AZ
124,2015,May,60.4,56.7,3179024,2983595,195429,6.1,AZ
125,2015,Jun,60.4,56.7,3183495,2988875,194620,6.1,AZ
126,2015,Jul,60.4,56.7,3187178,2993303,193875,6.1,AZ
127,2015,Aug,60.3,56.7,3190286,2997349,192937,6.0,AZ
128,2015,Sep,60.3,56.7,3193508,3002093,191415,6.0,AZ
129,2015,Oct,60.3,56.7,3198236,3008840,189396,5.9,AZ
130,2015,Nov,60.3,56.8,3204955,3017642,187313,5.8,AZ
131,2015,Dec,60.3,56.8,3212709,3027448,185261,5.8,AZ
132,2016,Jan,60.4,56.9,3220542,3037144,183398,5.7,AZ
133,2016,Feb,60.4,57.0,3227960,3046025,181935,5.6,AZ
134,2016,Mar,60.4,57.1,3234359,3053620,180739,5.6,AZ
135,2016,Apr,60.4,57.1,3239833,3059997,179836,5.6,AZ
136,2016,May,60.4,57.1,3245197,3065928,179269,5.5,AZ
137,2016,Jun,60.4,57.1,3250898,3072085,178813,5.5,AZ
138,2016,Jul,60.4,57.1,3256816,3078706,178110,5.5,AZ
139,2016,Aug,60.4,57.2,3262727,3085510,177217,5.4,AZ
140,2016,Sep,60.4,57.2,3268544,3092046,176498,5.4,AZ
141,2016,Oct,60.4,57.2,3274187,3098339,175848,5.4,AZ
142,2016,Nov,60.4,57.2,3280006,3105116,174890,5.3,AZ
143,2016,Dec,60.5,57.3,3286375,3112781,173594,5.3,AZ
144,2017,Jan,60.5,57.3,3207827,3040381,167446,5.2,AZ
145,2017,Feb,60.5,57.4,3214755,3049108,165647,5.2,AZ
146,2017,Mar,60.6,57.5,3222018,3058180,163838,5.1,AZ
147,2017,Apr,60.7,57.6,3229183,3067067,162116,5.0,AZ
148,2017,May,60.7,57.7,3235526,3075187,160339,5.0,AZ
149,2017,Jun,60.7,57.8,3240691,3081904,158787,4.9,AZ
150,2017,Jul,60.7,57.8,3245145,3087275,157870,4.9,AZ
151,2017,Aug,60.7,57.8,3248948,3091379,157569,4.8,AZ
152,2017,Sep,60.7,57.7,3252264,3094480,157784,4.9,AZ
153,2017,Oct,60.6,57.7,3255727,3097498,158229,4.9,AZ
154,2017,Nov,60.6,57.7,3260024,3101312,158712,4.9,AZ
155,2017,Dec,60.7,57.7,3265952,3107262,158690,4.9,AZ
156,2018,Jan,60.7,57.8,3273805,3115713,158092,4.8,AZ
157,2018,Feb,60.8,57.9,3283642,3126500,157142,4.8,AZ
158,2018,Mar,60.9,58.1,3294609,3138598,156011,4.7,AZ
159,2018,Apr,61.1,58.2,3305181,3150198,154983,4.7,AZ
160,2018,May,61.2,58.3,3314729,3160051,154678,4.7,AZ
161,2018,Jun,61.2,58.4,3323615,3168258,155357,4.7,AZ
162,2018,Jul,61.3,58.4,3332174,3175224,156950,4.7,AZ
163,2018,Aug,61.4,58.4,3341526,3181911,159615,4.8,AZ
164,2018,Sep,61.4,58.5,3351981,3188931,163050,4.9,AZ
165,2018,Oct,61.5,58.5,3362689,3196310,166379,4.9,AZ
166,2018,Nov,61.6,58.5,3372618,3203916,168702,5.0,AZ
167,2018,Dec,61.7,58.6,3381265,3211697,169568,5.0,AZ
168,2019,Jan,61.7,58.6,3388861,3219772,169089,5.0,AZ
169,2019,Feb,61.8,58.7,3395900,3228407,167493,4.9,AZ
170,2019,Mar,61.8,58.8,3403114,3237376,165738,4.9,AZ
171,2019,Apr,61.9,58.9,3411191,3246786,164405,4.8,AZ
172,2019,May,61.9,59.0,3419960,3256037,163923,4.8,AZ
173,2019,Jun,62.0,59.0,3429122,3264545,164577,4.8,AZ
174,2019,Jul,62.1,59.1,3438010,3271994,166016,4.8,AZ
175,2019,Aug,62.1,59.1,3446052,3278754,167298,4.9,AZ
176,2019,Sep,62.1,59.1,3453772,3286299,167473,4.8,AZ
177,2019,Oct,62.1,59.1,3462324,3294676,167648,4.8,AZ
178,2019,Nov,62.2,59.2,3471514,3302812,168702,4.9,AZ
179,2019,Dec,62.2,59.2,3478699,3308073,170626,4.9,AZ
180,2020,Jan,62.2,59.1,3481405,3308621,172784,5.0,AZ
181,2020,Feb,62.0,58.9,3479167,3304189,174978,5.0,AZ
182,2020,Mar,61.8,58.7,3474013,3297225,176788,5.1,AZ
183,2020,Apr,60.3,51.9,3393096,2919929,473167,13.9,AZ
184,2020,May,60.9,54.2,3432853,3053663,379190,11.0,AZ
185,2020,Jun,60.7,54.9,3426571,3101634,324937,9.5,AZ
186,2020,Jul,60.9,55.6,3442991,3147185,295806,8.6,AZ
187,2020,Aug,60.8,56.2,3447119,3184361,262758,7.6,AZ
188,2020,Sep,61.1,56.6,3465285,3214835,250450,7.2,AZ
189,2020,Oct,61.0,56.9,3469010,3235644,233366,6.7,AZ
190,2020,Nov,61.0,57.1,3475251,3250125,225126,6.5,AZ
191,2020,Dec,61.1,57.2,3482051,3261175,220876,6.3,AZ
192,2021,Jan,61.1,57.3,3486137,3272202,213935,6.1,AZ
193,2021,Feb,61.1,57.5,3494553,3284849,209704,6.0,AZ
194,2021,Mar,61.2,57.6,3503517,3299435,204082,5.8,AZ
195,2021,Apr,61.3,57.8,3512702,3314631,198071,5.6,AZ
196,2021,May,61.3,58.0,3519581,3329319,190262,5.4,AZ
197,2021,Jun,61.3,58.1,3525185,3342335,182850,5.2,AZ
198,2021,Jul,61.2,58.2,3527687,3355550,172137,4.9,AZ
199,2021,Aug,61.1,58.4,3528408,3368401,160007,4.5,AZ
200,2021,Sep,61.0,58.5,3528812,3381004,147808,4.2,AZ
201,2021,Oct,60.9,58.5,3530300,3391431,138869,3.9,AZ
202,2021,Nov,60.8,58.5,3530829,3394228,136601,3.9,AZ
203,2021,Dec,60.7,58.4,3531104,3394307,136797,3.9,AZ
204,2022,Jan,60.7,58.5,3536281,3406634,129647,3.7,AZ
205,2022,Feb,60.8,58.6,3543498,3417664,125834,3.6,AZ
206,2022,Mar,60.7,58.7,3548670,3431900,116770,3.3,AZ
207,2022,Apr,60.8,58.8,3556902,3441953,114949,3.2,AZ
208,2022,May,60.9,58.9,3569541,3454446,115095,3.2,AZ
209,2022,Jun,60.9,58.9,3577764,3460874,116890,3.3,AZ
210,2022,Jul,60.9,58.9,3584437,3465695,118742,3.3,AZ
211,2022,Aug,61.0,58.9,3595506,3470456,125050,3.5,AZ
212,2022,Sep,61.1,58.8,3607213,3473733,133480,3.7,AZ
213,2022,Oct,61.1,58.7,3616745,3474163,142582,3.9,AZ
214,2022,Nov,61.1,58.7,3623152,3476051,147101,4.1,AZ
0,2005,Jan,70.2,67.7,346365,334412,11953,3.5,VT
1,2005,Feb,70.2,67.8,346736,334776,11960,3.4,VT
2,2005,Mar,70.3,67.8,347219,335273,11946,3.4,VT
3,2005,Apr,70.3,67.9,347780,335872,11908,3.4,VT
4,2005,May,70.4,68.0,348442,336553,11889,3.4,VT
5,2005,Jun,70.5,68.1,349161,337233,11928,3.4,VT
6,2005,Jul,70.6,68.2,349868,337831,12037,3.4,VT
7,2005,Aug,70.7,68.2,350538,338360,12178,3.5,VT
8,2005,Sep,70.8,68.3,351183,338880,12303,3.5,VT
9,2005,Oct,70.8,68.3,351830,339450,12380,3.5,VT
10,2005,Nov,70.9,68.4,352432,340020,12412,3.5,VT
11,2005,Dec,70.9,68.4,352929,340528,12401,3.5,VT
12,2006,Jan,71.0,68.5,353344,340982,12362,3.5,VT
13,2006,Feb,71.0,68.5,353706,341368,12338,3.5,VT
14,2006,Mar,71.0,68.5,354035,341639,12396,3.5,VT
15,2006,Apr,71.1,68.5,354370,341788,12582,3.6,VT
16,2006,May,71.1,68.5,354749,341898,12851,3.6,VT
17,2006,Jun,71.1,68.5,355183,342044,13139,3.7,VT
18,2006,Jul,71.2,68.5,355703,342294,13409,3.8,VT
19,2006,Aug,71.3,68.5,356239,342595,13644,3.8,VT
20,2006,Sep,71.3,68.5,356647,342812,13835,3.9,VT
21,2006,Oct,71.3,68.5,356823,342892,13931,3.9,VT
22,2006,Nov,71.3,68.5,356762,342822,13940,3.9,VT
23,2006,Dec,71.2,68.4,356469,342563,13906,3.9,VT
24,2007,Jan,71.0,68.3,355976,342115,13861,3.9,VT
25,2007,Feb,70.9,68.1,355401,341580,13821,3.9,VT
26,2007,Mar,70.8,68.0,354803,341022,13781,3.9,VT
27,2007,Apr,70.6,67.9,354210,340469,13741,3.9,VT
28,2007,May,70.5,67.7,353648,339909,13739,3.9,VT
29,2007,Jun,70.3,67.6,353120,339337,13783,3.9,VT
30,2007,Jul,70.2,67.4,352634,338784,13850,3.9,VT
31,2007,Aug,70.1,67.3,352250,338324,13926,4.0,VT
32,2007,Sep,70.0,67.2,352038,338053,13985,4.0,VT
33,2007,Oct,70.0,67.2,351966,337926,14040,4.0,VT
34,2007,Nov,69.9,67.1,351983,337899,14084,4.0,VT
35,2007,Dec,69.9,67.1,352068,337945,14123,4.0,VT
36,2008,Jan,69.9,67.1,352192,337980,14212,4.0,VT
37,2008,Feb,69.9,67.1,352351,337975,14376,4.1,VT
38,2008,Mar,70.0,67.1,352567,337934,14633,4.2,VT
39,2008,Apr,70.0,67.0,352841,337854,14987,4.2,VT
40,2008,May,70.0,67.0,353179,337781,15398,4.4,VT
41,2008,Jun,70.1,66.9,353581,337764,15817,4.5,VT
42,2008,Jul,70.1,66.9,353970,337768,16202,4.6,VT
43,2008,Aug,70.1,66.9,354246,337699,16547,4.7,VT
44,2008,Sep,70.1,66.8,354355,337442,16913,4.8,VT
45,2008,Oct,70.3,66.9,355352,337955,17397,4.9,VT
46,2008,Nov,70.4,66.9,356228,338176,18052,5.1,VT
47,2008,Dec,70.6,66.8,357013,338155,18858,5.3,VT
48,2009,Jan,70.7,66.8,357735,337995,19740,5.5,VT
49,2009,Feb,70.8,66.7,358464,337853,20611,5.7,VT
50,2009,Mar,71.0,66.7,359307,337951,21356,5.9,VT
51,2009,Apr,71.0,66.7,359755,337870,21885,6.1,VT
52,2009,May,71.3,66.9,361124,338923,22201,6.1,VT
53,2009,Jun,71.2,66.8,360821,338444,22377,6.2,VT
54,2009,Jul,71.1,66.6,360377,337862,22515,6.2,VT
55,2009,Aug,70.9,66.4,359802,337117,22685,6.3,VT
56,2009,Sep,70.7,66.2,359182,336279,22903,6.4,VT
57,2009,Oct,70.6,66.0,358651,335482,23169,6.5,VT
58,2009,Nov,70.5,65.9,358407,334938,23469,6.5,VT
59,2009,Dec,70.5,65.8,358555,334803,23752,6.6,VT
60,2010,Jan,70.6,65.9,359006,335086,23920,6.7,VT
61,2010,Feb,70.6,65.9,359539,335633,23906,6.6,VT
62,2010,Mar,70.7,66.0,359952,336236,23716,6.6,VT
63,2010,Apr,71.1,66.5,360198,336797,23401,6.5,VT
64,2010,May,71.1,66.6,360279,337283,22996,6.4,VT
65,2010,Jun,71.1,66.6,360157,337576,22581,6.3,VT
66,2010,Jul,71.0,66.6,359881,337624,22257,6.2,VT
67,2010,Aug,70.9,66.5,359635,337553,22082,6.1,VT
68,2010,Sep,70.8,66.5,359493,337459,22034,6.1,VT
69,2010,Oct,70.7,66.4,359468,337452,22016,6.1,VT
70,2010,Nov,70.7,66.4,359473,337528,21945,6.1,VT
71,2010,Dec,70.7,66.4,359459,337650,21809,6.1,VT
72,2011,Jan,70.6,66.4,359441,337829,21612,6.0,VT
73,2011,Feb,70.6,66.4,359320,337959,21361,5.9,VT
74,2011,Mar,70.5,66.3,358981,337921,21060,5.9,VT
75,2011,Apr,70.3,66.2,358434,337692,20742,5.8,VT
76,2011,May,70.2,66.1,357830,337364,20466,5.7,VT
77,2011,Jun,70.0,66.1,357343,337129,20214,5.7,VT
78,2011,Jul,69.9,66.0,357058,337145,19913,5.6,VT
79,2011,Aug,69.9,66.1,356927,337389,19538,5.5,VT
80,2011,Sep,69.9,66.1,356866,337751,19115,5.4,VT
81,2011,Oct,69.8,66.2,356776,338090,18686,5.2,VT
82,2011,Nov,69.8,66.2,356508,338251,18257,5.1,VT
83,2011,Dec,69.7,66.2,356006,338170,17836,5.0,VT
84,2012,Jan,69.5,66.1,355362,337888,17474,4.9,VT
85,2012,Feb,69.4,66.0,354783,337552,17231,4.9,VT
86,2012,Mar,69.3,66.0,354381,337236,17145,4.8,VT
87,2012,Apr,69.3,65.9,354130,336947,17183,4.9,VT
88,2012,May,69.2,65.9,354020,336755,17265,4.9,VT
89,2012,Jun,69.2,65.9,353999,336688,17311,4.9,VT
90,2012,Jul,69.2,65.8,353993,336722,17271,4.9,VT
91,2012,Aug,69.2,65.8,353956,336820,17136,4.8,VT
92,2012,Sep,69.1,65.8,353835,336908,16927,4.8,VT
93,2012,Oct,69.1,65.8,353543,336872,16671,4.7,VT
94,2012,Nov,69.0,65.7,353111,336683,16428,4.7,VT
95,2012,Dec,68.8,65.7,352575,336348,16227,4.6,VT
96,2013,Jan,68.7,65.6,351969,335874,16095,4.6,VT
97,2013,Feb,68.6,65.5,351387,335357,16030,4.6,VT
98,2013,Mar,68.5,65.4,350931,334949,15982,4.6,VT
99,2013,Apr,68.4,65.3,350684,334772,15912,4.5,VT
100,2013,May,68.4,65.3,350554,334741,15813,4.5,VT
101,2013,Jun,68.3,65.3,350425,334728,15697,4.5,VT
102,2013,Jul,68.3,65.3,350240,334676,15564,4.4,VT
103,2013,Aug,68.2,65.2,349953,334580,15373,4.4,VT
104,2013,Sep,68.1,65.2,349601,334486,15115,4.3,VT
105,2013,Oct,68.1,65.2,349300,334450,14850,4.3,VT
106,2013,Nov,68.0,65.2,349089,334466,14623,4.2,VT
107,2013,Dec,68.0,65.2,348937,334491,14446,4.1,VT
108,2014,Jan,68.0,65.2,348806,334528,14278,4.1,VT
109,2014,Feb,67.9,65.2,348678,334573,14105,4.0,VT
110,2014,Mar,67.9,65.2,348585,334605,13980,4.0,VT
111,2014,Apr,67.9,65.2,348513,334580,13933,4.0,VT
112,2014,May,67.9,65.2,348496,334560,13936,4.0,VT
113,2014,Jun,67.9,65.2,348595,334637,13958,4.0,VT
114,2014,Jul,67.9,65.2,348732,334745,13987,4.0,VT
115,2014,Aug,67.9,65.2,348863,334843,14020,4.0,VT
116,2014,Sep,67.9,65.2,348966,334944,14022,4.0,VT
117,2014,Oct,67.9,65.2,348999,335064,13935,4.0,VT
118,2014,Nov,67.9,65.2,348937,335207,13730,3.9,VT
119,2014,Dec,67.8,65.2,348838,335378,13460,3.9,VT
120,2015,Jan,67.8,65.2,348721,335527,13194,3.8,VT
121,2015,Feb,67.7,65.2,348536,335570,12966,3.7,VT
122,2015,Mar,67.7,65.2,348217,335461,12756,3.7,VT
123,2015,Apr,67.6,65.1,347766,335199,12567,3.6,VT
124,2015,May,67.5,65.0,347189,334785,12404,3.6,VT
125,2015,Jun,67.3,64.9,346525,334255,12270,3.5,VT
126,2015,Jul,67.2,64.8,345899,333746,12153,3.5,VT
127,2015,Aug,67.1,64.7,345384,333349,12035,3.5,VT
128,2015,Sep,67.0,64.7,345015,333114,11901,3.4,VT
129,2015,Oct,66.9,64.7,344859,333101,11758,3.4,VT
130,2015,Nov,66.9,64.7,344913,333306,11607,3.4,VT
131,2015,Dec,67.0,64.8,345067,333646,11421,3.3,VT
132,2016,Jan,67.0,64.8,345245,334036,11209,3.2,VT
133,2016,Feb,67.1,64.9,345423,334400,11023,3.2,VT
134,2016,Mar,67.1,65.0,345578,334690,10888,3.2,VT
135,2016,Apr,67.1,65.0,345690,334876,10814,3.1,VT
136,2016,May,67.1,65.0,345778,334986,10792,3.1,VT
137,2016,Jun,67.1,65.0,345859,335071,10788,3.1,VT
138,2016,Jul,67.1,65.0,345924,335154,10770,3.1,VT
139,2016,Aug,67.1,65.0,345995,335259,10736,3.1,VT
140,2016,Sep,67.1,65.0,346058,335351,10707,3.1,VT
141,2016,Oct,67.1,65.0,346102,335396,10706,3.1,VT
142,2016,Nov,67.1,65.0,346202,335457,10745,3.1,VT
143,2016,Dec,67.1,65.0,346418,335584,10834,3.1,VT
144,2017,Jan,67.3,65.2,354265,343122,11143,3.1,VT
145,2017,Feb,67.3,65.2,354646,343512,11134,3.1,VT
146,2017,Mar,67.4,65.3,354970,343933,11037,3.1,VT
147,2017,Apr,67.4,65.3,355243,344374,10869,3.1,VT
148,2017,May,67.4,65.4,355445,344781,10664,3.0,VT
149,2017,Jun,67.4,65.4,355561,345064,10497,3.0,VT
150,2017,Jul,67.4,65.4,355638,345221,10417,2.9,VT
151,2017,Aug,67.3,65.4,355664,345249,10415,2.9,VT
152,2017,Sep,67.3,65.3,355642,345179,10463,2.9,VT
153,2017,Oct,67.3,65.3,355610,345095,10515,3.0,VT
154,2017,Nov,67.2,65.2,355605,345035,10570,3.0,VT
155,2017,Dec,67.2,65.2,355711,345122,10589,3.0,VT
156,2018,Jan,67.3,65.3,355982,345428,10554,3.0,VT
157,2018,Feb,67.3,65.4,356426,345967,10459,2.9,VT
158,2018,Mar,67.4,65.5,356929,346643,10286,2.9,VT
159,2018,Apr,67.5,65.6,357314,347273,10041,2.8,VT
160,2018,May,67.5,65.6,357458,347703,9755,2.7,VT
161,2018,Jun,67.4,65.6,357324,347882,9442,2.6,VT
162,2018,Jul,67.3,65.6,356929,347799,9130,2.6,VT
163,2018,Aug,67.2,65.5,356434,347569,8865,2.5,VT
164,2018,Sep,67.1,65.4,355987,347338,8649,2.4,VT
165,2018,Oct,67.0,65.4,355670,347211,8459,2.4,VT
166,2018,Nov,66.9,65.4,355533,347230,8303,2.3,VT
167,2018,Dec,66.9,65.4,355535,347384,8151,2.3,VT
168,2019,Jan,66.9,65.4,355602,347626,7976,2.2,VT
169,2019,Feb,66.9,65.4,355632,347873,7759,2.2,VT
170,2019,Mar,66.9,65.5,355582,348017,7565,2.1,VT
171,2019,Apr,66.8,65.4,355484,348026,7458,2.1,VT
172,2019,May,66.8,65.4,355359,347871,7488,2.1,VT
173,2019,Jun,66.8,65.3,355287,347583,7704,2.2,VT
174,2019,Jul,66.7,65.2,355359,347258,8101,2.3,VT
175,2019,Aug,66.8,65.1,355624,347026,8598,2.4,VT
176,2019,Sep,66.8,65.1,356107,347048,9059,2.5,VT
177,2019,Oct,66.9,65.1,356663,347295,9368,2.6,VT
178,2019,Nov,66.9,65.2,356961,347608,9353,2.6,VT
179,2019,Dec,66.8,65.1,356792,347628,9164,2.6,VT
180,2020,Jan,66.7,65.0,356211,347148,9063,2.5,VT
181,2020,Feb,66.6,64.8,355409,346225,9184,2.6,VT
182,2020,Mar,66.4,64.6,354712,345190,9522,2.7,VT
183,2020,Apr,68.1,58.3,363610,311439,52171,14.3,VT
184,2020,May,64.5,58.4,344715,311880,32835,9.5,VT
185,2020,Jun,63.3,58.5,338027,312325,25702,7.6,VT
186,2020,Jul,62.8,58.8,335153,313804,21349,6.4,VT
187,2020,Aug,62.1,58.9,331791,314718,17073,5.1,VT
188,2020,Sep,61.8,59.0,330539,315650,14889,4.5,VT
189,2020,Oct,61.4,58.9,328559,315478,13081,4.0,VT
190,2020,Nov,61.2,58.8,327603,315068,12535,3.8,VT
191,2020,Dec,61.0,58.7,327087,314535,12552,3.8,VT
192,2021,Jan,61.0,58.6,326828,314222,12606,3.9,VT
193,2021,Feb,61.0,58.6,327042,314363,12679,3.9,VT
194,2021,Mar,61.0,58.7,327547,315000,12547,3.8,VT
195,2021,Apr,61.1,58.8,328125,315875,12250,3.7,VT
196,2021,May,61.1,58.9,328514,316717,11797,3.6,VT
197,2021,Jun,61.1,59.0,328659,317280,11379,3.5,VT
198,2021,Jul,61.0,59.0,328436,317455,10981,3.3,VT
199,2021,Aug,60.9,59.0,328348,317685,10663,3.2,VT
200,2021,Sep,60.9,59.0,328358,317942,10416,3.2,VT
201,2021,Oct,60.9,59.0,328586,318390,10196,3.1,VT
202,2021,Nov,60.8,58.9,328546,318415,10131,3.1,VT
203,2021,Dec,60.8,58.9,328535,318426,10109,3.1,VT
204,2022,Jan,60.9,59.0,329365,319422,9943,3.0,VT
205,2022,Feb,60.9,59.2,330023,320496,9527,2.9,VT
206,2022,Mar,61.2,59.5,331430,322649,8781,2.6,VT
207,2022,Apr,61.4,59.8,332746,324538,8208,2.5,VT
208,2022,May,61.5,60.1,333577,326018,7559,2.3,VT
209,2022,Jun,61.6,60.3,334725,327480,7245,2.2,VT
210,2022,Jul,61.7,60.4,335605,328616,6989,2.1,VT
211,2022,Aug,61.8,60.5,336176,329181,6995,2.1,VT
212,2022,Sep,61.8,60.5,336490,329284,7206,2.1,VT
213,2022,Oct,61.7,60.3,336423,328697,7726,2.3,VT
214,2022,Nov,61.7,60.2,336761,328488,8273,2.5,VT
0,2005,Jan,72.6,68.7,2554891,2416722,138169,5.4,CO
1,2005,Feb,72.6,68.7,2556829,2419263,137566,5.4,CO
2,2005,Mar,72.5,68.7,2559265,2422811,136454,5.3,CO
3,2005,Apr,72.5,68.7,2562139,2427282,134857,5.3,CO
4,2005,May,72.5,68.8,2565371,2432503,132868,5.2,CO
5,2005,Jun,72.5,68.8,2568581,2437884,130697,5.1,CO
6,2005,Jul,72.5,68.9,2571894,2443117,128777,5.0,CO
7,2005,Aug,72.5,68.9,2575669,2448234,127435,4.9,CO
8,2005,Sep,72.5,68.9,2580186,2453632,126554,4.9,CO
9,2005,Oct,72.4,68.9,2585429,2460026,125403,4.9,CO
10,2005,Nov,72.4,69.0,2591508,2467857,123651,4.8,CO
11,2005,Dec,72.5,69.1,2598074,2476752,121322,4.7,CO
12,2006,Jan,72.6,69.3,2605057,2486296,118761,4.6,CO
13,2006,Feb,72.7,69.4,2612418,2495895,116523,4.5,CO
14,2006,Mar,72.8,69.6,2620070,2504897,115173,4.4,CO
15,2006,Apr,72.9,69.7,2627673,2512768,114905,4.4,CO
16,2006,May,72.9,69.8,2634815,2519556,115259,4.4,CO
17,2006,Jun,73.0,69.8,2641282,2525693,115589,4.4,CO
18,2006,Jul,73.0,69.9,2647155,2532065,115090,4.3,CO
19,2006,Aug,73.1,69.9,2652385,2538867,113518,4.3,CO
20,2006,Sep,73.1,70.0,2656964,2545785,111179,4.2,CO
21,2006,Oct,73.0,70.1,2660820,2552545,108275,4.1,CO
22,2006,Nov,73.0,70.1,2663422,2558561,104861,3.9,CO
23,2006,Dec,72.9,70.1,2664298,2563203,101095,3.8,CO
24,2007,Jan,72.8,70.1,2663897,2566479,97418,3.7,CO
25,2007,Feb,72.7,70.1,2663475,2569153,94322,3.5,CO
26,2007,Mar,72.6,70.1,2664085,2572031,92054,3.5,CO
27,2007,Apr,72.5,70.0,2666633,2575603,91030,3.4,CO
28,2007,May,72.5,70.0,2671638,2580013,91625,3.4,CO
29,2007,Jun,72.6,70.1,2678950,2585195,93755,3.5,CO
30,2007,Jul,72.7,70.1,2687730,2590676,97054,3.6,CO
31,2007,Aug,72.9,70.1,2697211,2596232,100979,3.7,CO
32,2007,Sep,73.0,70.2,2706470,2601718,104752,3.9,CO
33,2007,Oct,73.1,70.2,2714544,2606543,108001,4.0,CO
34,2007,Nov,73.1,70.2,2721095,2610602,110493,4.1,CO
35,2007,Dec,73.1,70.1,2726104,2613895,112209,4.1,CO
36,2008,Jan,73.1,70.1,2729192,2615692,113500,4.2,CO
37,2008,Feb,73.0,70.0,2730710,2615827,114883,4.2,CO
38,2008,Mar,72.9,69.8,2731524,2614588,116936,4.3,CO
39,2008,Apr,72.8,69.6,2732182,2612373,119809,4.4,CO
40,2008,May,72.7,69.5,2733114,2609574,123540,4.5,CO
41,2008,Jun,72.6,69.2,2734443,2606433,128010,4.7,CO
42,2008,Jul,72.6,69.0,2735689,2603060,132629,4.8,CO
43,2008,Aug,72.5,68.8,2736631,2599477,137154,5.0,CO
44,2008,Sep,72.4,68.6,2737389,2595132,142257,5.2,CO
45,2008,Oct,72.3,68.3,2738037,2589291,148746,5.4,CO
46,2008,Nov,72.2,68.0,2738762,2581484,157278,5.7,CO
47,2008,Dec,72.1,67.7,2739993,2572099,167894,6.1,CO
48,2009,Jan,72.0,67.3,2741783,2561844,179939,6.6,CO
49,2009,Feb,72.0,66.9,2743809,2551450,192359,7.0,CO
50,2009,Mar,71.9,66.6,2745639,2541992,203647,7.4,CO
51,2009,Apr,71.8,66.3,2746627,2534133,212494,7.7,CO
52,2009,May,71.7,66.0,2745488,2527186,218302,8.0,CO
53,2009,Jun,71.5,65.7,2741685,2520583,221102,8.1,CO
54,2009,Jul,71.2,65.4,2735370,2513522,221848,8.1,CO
55,2009,Aug,70.9,65.1,2727247,2505320,221927,8.1,CO
56,2009,Sep,70.6,64.8,2718739,2496342,222397,8.2,CO
57,2009,Oct,70.3,64.5,2711692,2487400,224292,8.3,CO
58,2009,Nov,70.1,64.2,2708033,2479744,228289,8.4,CO
59,2009,Dec,70.0,64.0,2708249,2474419,233830,8.6,CO
60,2010,Jan,70.0,63.8,2711291,2471793,239498,8.8,CO
61,2010,Feb,70.0,63.8,2714852,2471124,243728,9.0,CO
62,2010,Mar,70.0,63.7,2717321,2471367,245954,9.1,CO
63,2010,Apr,70.6,64.2,2718188,2471781,246407,9.1,CO
64,2010,May,70.5,64.2,2717428,2471774,245654,9.0,CO
65,2010,Jun,70.4,64.1,2715479,2470389,245090,9.0,CO
66,2010,Jul,70.3,63.9,2713677,2467557,246120,9.1,CO
67,2010,Aug,70.2,63.7,2713080,2464356,248724,9.2,CO
68,2010,Sep,70.1,63.6,2713611,2461710,251901,9.3,CO
69,2010,Oct,70.0,63.4,2714795,2460636,254159,9.4,CO
70,2010,Nov,69.9,63.4,2715531,2461626,253905,9.4,CO
71,2010,Dec,69.8,63.4,2715890,2464572,251318,9.3,CO
72,2011,Jan,69.7,63.4,2716453,2469040,247413,9.1,CO
73,2011,Feb,69.7,63.4,2717045,2474007,243038,8.9,CO
74,2011,Mar,69.6,63.5,2717265,2478257,239008,8.8,CO
75,2011,Apr,69.5,63.5,2717501,2481268,236233,8.7,CO
76,2011,May,69.4,63.4,2719021,2483775,235246,8.7,CO
77,2011,Jun,69.4,63.4,2722599,2487089,235510,8.7,CO
78,2011,Jul,69.5,63.5,2728230,2492162,236068,8.7,CO
79,2011,Aug,69.5,63.5,2735039,2498664,236375,8.6,CO
80,2011,Sep,69.6,63.6,2741753,2505623,236130,8.6,CO
81,2011,Oct,69.6,63.7,2747237,2511976,235261,8.6,CO
82,2011,Nov,69.6,63.7,2750166,2516276,233890,8.5,CO
83,2011,Dec,69.5,63.6,2749769,2517876,231893,8.4,CO
84,2012,Jan,69.3,63.5,2747283,2517729,229554,8.4,CO
85,2012,Feb,69.2,63.4,2744941,2517116,227825,8.3,CO
86,2012,Mar,69.1,63.3,2743601,2516649,226952,8.3,CO
87,2012,Apr,69.0,63.3,2743294,2516847,226447,8.3,CO
88,2012,May,68.9,63.2,2744233,2518570,225663,8.2,CO
89,2012,Jun,68.8,63.2,2746042,2521989,224053,8.2,CO
90,2012,Jul,68.8,63.2,2748077,2526809,221268,8.1,CO
91,2012,Aug,68.7,63.3,2750560,2532901,217659,7.9,CO
92,2012,Sep,68.7,63.4,2753956,2539967,213989,7.8,CO
93,2012,Oct,68.7,63.4,2757466,2546891,210575,7.6,CO
94,2012,Nov,68.7,63.5,2760368,2552987,207381,7.5,CO
95,2012,Dec,68.6,63.5,2762211,2558031,204180,7.4,CO
96,2013,Jan,68.5,63.5,2762675,2561687,200988,7.3,CO
97,2013,Feb,68.4,63.5,2762415,2564483,197932,7.2,CO
98,2013,Mar,68.3,63.5,2762705,2567602,195103,7.1,CO
99,2013,Apr,68.3,63.5,2764238,2571622,192616,7.0,CO
100,2013,May,68.2,63.5,2766305,2575647,190658,6.9,CO
101,2013,Jun,68.2,63.5,2768303,2579085,189218,6.8,CO
102,2013,Jul,68.1,63.5,2769662,2581932,187730,6.8,CO
103,2013,Aug,68.0,63.4,2769322,2584166,185156,6.7,CO
104,2013,Sep,67.8,63.4,2767570,2586419,181151,6.5,CO
105,2013,Oct,67.7,63.4,2766264,2589867,176397,6.4,CO
106,2013,Nov,67.6,63.4,2767651,2595558,172093,6.2,CO
107,2013,Dec,67.6,63.5,2772177,2603433,168744,6.1,CO
108,2014,Jan,67.7,63.6,2778644,2613030,165614,6.0,CO
109,2014,Feb,67.8,63.8,2785590,2623718,161872,5.8,CO
110,2014,Mar,67.8,64.0,2791859,2634418,157441,5.6,CO
111,2014,Apr,67.8,64.1,2796320,2644060,152260,5.4,CO
112,2014,May,67.8,64.2,2799033,2652822,146211,5.2,CO
113,2014,Jun,67.7,64.3,2800957,2661226,139731,5.0,CO
114,2014,Jul,67.6,64.4,2802732,2669021,133711,4.8,CO
115,2014,Aug,67.6,64.5,2805239,2676304,128935,4.6,CO
116,2014,Sep,67.5,64.5,2808186,2682837,125349,4.5,CO
117,2014,Oct,67.4,64.5,2810762,2688227,122535,4.4,CO
118,2014,Nov,67.3,64.5,2811968,2691945,120023,4.3,CO
119,2014,Dec,67.2,64.4,2812244,2694387,117857,4.2,CO
120,2015,Jan,67.1,64.3,2812740,2696305,116435,4.1,CO
121,2015,Feb,67.0,64.3,2813690,2698184,115506,4.1,CO
122,2015,Mar,66.9,64.2,2815196,2700859,114337,4.1,CO
123,2015,Apr,66.9,64.2,2817304,2704794,112510,4.0,CO
124,2015,May,66.8,64.2,2819533,2709579,109954,3.9,CO
125,2015,Jun,66.7,64.2,2821315,2714525,106790,3.8,CO
126,2015,Jul,66.6,64.2,2823037,2719557,103480,3.7,CO
127,2015,Aug,66.5,64.2,2825443,2724952,100491,3.6,CO
128,2015,Sep,66.5,64.2,2829407,2731343,98064,3.5,CO
129,2015,Oct,66.5,64.3,2835695,2739313,96382,3.4,CO
130,2015,Nov,66.6,64.4,2844179,2748716,95463,3.4,CO
131,2015,Dec,66.7,64.5,2853704,2758635,95069,3.3,CO
132,2016,Jan,66.8,64.6,2862652,2767788,94864,3.3,CO
133,2016,Feb,66.9,64.7,2870218,2775432,94786,3.3,CO
134,2016,Mar,66.9,64.7,2876122,2781378,94744,3.3,CO
135,2016,Apr,66.9,64.7,2880932,2786260,94672,3.3,CO
136,2016,May,66.9,64.7,2885680,2791195,94485,3.3,CO
137,2016,Jun,66.9,64.8,2891014,2797121,93893,3.2,CO
138,2016,Jul,66.9,64.8,2896793,2804247,92546,3.2,CO
139,2016,Aug,67.0,64.9,2902625,2812008,90617,3.1,CO
140,2016,Sep,67.0,65.0,2908090,2819516,88574,3.0,CO
141,2016,Oct,67.0,65.0,2912869,2826596,86273,3.0,CO
142,2016,Nov,67.0,65.1,2917546,2834159,83387,2.9,CO
143,2016,Dec,67.0,65.2,2922961,2842900,80061,2.7,CO
144,2017,Jan,67.0,65.3,2911905,2836089,75816,2.6,CO
145,2017,Feb,67.1,65.5,2920347,2847403,72944,2.5,CO
146,2017,Mar,67.3,65.6,2930285,2859106,71179,2.4,CO
147,2017,Apr,67.4,65.8,2941271,2870457,70814,2.4,CO
148,2017,May,67.6,66.0,2952554,2880674,71880,2.4,CO
149,2017,Jun,67.8,66.1,2963235,2888997,74238,2.5,CO
150,2017,Jul,67.9,66.1,2973006,2895586,77420,2.6,CO
151,2017,Aug,68.0,66.1,2981249,2900866,80383,2.7,CO
152,2017,Sep,68.0,66.1,2987772,2905274,82498,2.8,CO
153,2017,Oct,68.0,66.1,2993236,2909396,83840,2.8,CO
154,2017,Nov,68.1,66.1,2998232,2913494,84738,2.8,CO
155,2017,Dec,68.1,66.2,3003856,2918625,85231,2.8,CO
156,2018,Jan,68.2,66.2,3011265,2925684,85581,2.8,CO
157,2018,Feb,68.3,66.3,3021061,2934778,86283,2.9,CO
158,2018,Mar,68.5,66.5,3032276,2944618,87658,2.9,CO
159,2018,Apr,68.6,66.6,3042661,2953048,89613,2.9,CO
160,2018,May,68.7,66.6,3050463,2958696,91767,3.0,CO
161,2018,Jun,68.7,66.6,3055260,2961635,93625,3.1,CO
162,2018,Jul,68.6,66.5,3057518,2962584,94934,3.1,CO
163,2018,Aug,68.6,66.4,3058712,2962957,95755,3.1,CO
164,2018,Sep,68.5,66.3,3060322,2964255,96067,3.1,CO
165,2018,Oct,68.5,66.3,3063162,2967541,95621,3.1,CO
166,2018,Nov,68.5,66.4,3067446,2973061,94385,3.1,CO
167,2018,Dec,68.5,66.5,3072704,2980318,92386,3.0,CO
168,2019,Jan,68.6,66.6,3078085,2988314,89771,2.9,CO
169,2019,Feb,68.6,66.7,3082935,2996360,86575,2.8,CO
170,2019,Mar,68.6,66.8,3087255,3003973,83282,2.7,CO
171,2019,Apr,68.6,66.8,3091746,3011221,80525,2.6,CO
172,2019,May,68.6,66.9,3096196,3017467,78729,2.5,CO
173,2019,Jun,68.6,66.9,3100170,3022172,77998,2.5,CO
174,2019,Jul,68.6,66.9,3103416,3025390,78026,2.5,CO
175,2019,Aug,68.6,66.9,3106235,3027998,78237,2.5,CO
176,2019,Sep,68.6,66.9,3109722,3031501,78221,2.5,CO
177,2019,Oct,68.6,66.9,3114264,3035664,78600,2.5,CO
178,2019,Nov,68.6,66.9,3119391,3039557,79834,2.6,CO
179,2019,Dec,68.6,66.8,3122796,3040942,81854,2.6,CO
180,2020,Jan,68.6,66.7,3122529,3038414,84115,2.7,CO
181,2020,Feb,68.4,66.5,3117993,3032120,85873,2.8,CO
182,2020,Mar,69.6,66.3,3178419,3024629,153790,4.8,CO
183,2020,Apr,66.1,58.4,3018545,2667130,351415,11.6,CO
184,2020,May,67.9,59.9,3103940,2737435,366505,11.8,CO
185,2020,Jun,68.0,60.5,3111741,2770139,341602,11.0,CO
186,2020,Jul,65.6,61.3,3006748,2807950,198798,6.6,CO
187,2020,Aug,66.0,61.9,3027478,2839943,187535,6.2,CO
188,2020,Sep,66.7,62.5,3063615,2868371,195244,6.4,CO
189,2020,Oct,67.0,62.8,3076024,2887428,188596,6.1,CO
190,2020,Nov,67.3,63.1,3092744,2901044,191700,6.2,CO
191,2020,Dec,67.6,63.3,3111186,2911239,199947,6.4,CO
192,2021,Jan,67.7,63.4,3115249,2920988,194261,6.2,CO
193,2021,Feb,67.9,63.6,3126937,2932239,194698,6.2,CO
194,2021,Mar,68.0,63.9,3136851,2945538,191313,6.1,CO
195,2021,Apr,68.3,64.1,3149810,2959120,190690,6.1,CO
196,2021,May,68.3,64.4,3154026,2971450,182576,5.8,CO
197,2021,Jun,68.5,64.5,3167911,2981789,186122,5.9,CO
198,2021,Jul,68.5,64.7,3169069,2991698,177371,5.6,CO
199,2021,Aug,68.5,64.8,3171815,3002482,169333,5.3,CO
200,2021,Sep,68.3,65.0,3164367,3014432,149935,4.7,CO
201,2021,Oct,68.3,65.2,3169784,3026333,143451,4.5,CO
202,2021,Nov,68.3,65.3,3170872,3033312,137560,4.3,CO
203,2021,Dec,68.2,65.3,3170694,3037677,133017,4.2,CO
204,2022,Jan,68.5,65.7,3187407,3055113,132294,4.2,CO
205,2022,Feb,68.7,66.0,3199344,3072172,127172,4.0,CO
206,2022,Mar,68.9,66.4,3211977,3093476,118501,3.7,CO
207,2022,Apr,69.1,66.6,3225366,3108883,116483,3.6,CO
208,2022,May,69.4,66.9,3240564,3126055,114509,3.5,CO
209,2022,Jun,69.5,67.1,3248779,3137097,111682,3.4,CO
210,2022,Jul,69.5,67.2,3250281,3142810,107471,3.3,CO
211,2022,Aug,69.6,67.2,3257886,3146008,111878,3.4,CO
212,2022,Sep,69.4,67.1,3254981,3145390,109591,3.4,CO
213,2022,Oct,69.4,66.9,3256781,3140457,116324,3.6,CO
214,2022,Nov,69.2,66.8,3252051,3138429,113622,3.5,CO
0,2005,Jan,64.1,59.2,2053990,1899758,154232,7.5,SC
1,2005,Feb,63.9,59.1,2052650,1899188,153462,7.5,SC
2,2005,Mar,63.8,59.1,2051178,1899305,151873,7.4,SC
3,2005,Apr,63.7,59.0,2050227,1900329,149898,7.3,SC
4,2005,May,63.6,59.0,2050371,1902110,148261,7.2,SC
5,2005,Jun,63.5,59.0,2051815,1904122,147693,7.2,SC
6,2005,Jul,63.8,59.2,2063723,1915173,148550,7.2,SC
7,2005,Aug,64.1,59.4,2075567,1925332,150235,7.2,SC
8,2005,Sep,64.3,59.6,2086459,1934643,151816,7.3,SC
9,2005,Oct,64.4,59.7,2096077,1943514,152563,7.3,SC
10,2005,Nov,64.5,59.9,2105023,1952528,152495,7.2,SC
11,2005,Dec,64.7,60.0,2114205,1962317,151888,7.2,SC
12,2006,Jan,64.7,60.1,2119855,1968705,151150,7.1,SC
13,2006,Feb,65.1,60.5,2135776,1985178,150598,7.1,SC
14,2006,Mar,65.1,60.5,2138279,1987777,150502,7.0,SC
15,2006,Apr,65.1,60.5,2141052,1990230,150822,7.0,SC
16,2006,May,65.0,60.4,2143551,1992605,150946,7.0,SC
17,2006,Jun,65.0,60.4,2145543,1995143,150400,7.0,SC
18,2006,Jul,64.9,60.4,2147804,1998767,149037,6.9,SC
19,2006,Aug,64.9,60.5,2151562,2004201,147361,6.8,SC
20,2006,Sep,65.0,60.6,2157039,2011196,145843,6.8,SC
21,2006,Oct,65.0,60.7,2163454,2019114,144340,6.7,SC
22,2006,Nov,65.1,60.8,2169409,2026695,142714,6.6,SC
23,2006,Dec,65.1,60.9,2173063,2032325,140738,6.5,SC
24,2007,Jan,65.0,60.9,2173719,2035325,138394,6.4,SC
25,2007,Feb,64.9,60.8,2171850,2035894,135956,6.3,SC
26,2007,Mar,64.6,60.6,2167855,2034333,133522,6.2,SC
27,2007,Apr,64.4,60.5,2162781,2031551,131230,6.1,SC
28,2007,May,64.1,60.3,2157889,2028383,129506,6.0,SC
29,2007,Jun,63.9,60.1,2153733,2025355,128378,6.0,SC
30,2007,Jul,63.7,59.9,2150443,2022616,127827,5.9,SC
31,2007,Aug,63.5,59.7,2148004,2020142,127862,6.0,SC
32,2007,Sep,63.3,59.5,2146114,2018109,128005,6.0,SC
33,2007,Oct,63.2,59.4,2144524,2016549,127975,6.0,SC
34,2007,Nov,63.0,59.3,2143103,2015474,127629,6.0,SC
35,2007,Dec,62.9,59.2,2142197,2014876,127321,5.9,SC
36,2008,Jan,62.8,59.0,2142083,2014465,127618,6.0,SC
37,2008,Feb,62.7,58.9,2142958,2014109,128849,6.0,SC
38,2008,Mar,62.7,58.8,2145291,2013689,131602,6.1,SC
39,2008,Apr,62.7,58.7,2148967,2012754,136213,6.3,SC
40,2008,May,62.7,58.6,2153582,2011092,142490,6.6,SC
41,2008,Jun,62.8,58.4,2158755,2008838,149917,6.9,SC
42,2008,Jul,62.8,58.2,2163696,2006035,157661,7.3,SC
43,2008,Aug,62.9,58.1,2167886,2002548,165338,7.6,SC
44,2008,Sep,62.9,57.9,2171419,1997861,173558,8.0,SC
45,2008,Oct,62.9,57.6,2174417,1991342,183075,8.4,SC
46,2008,Nov,62.9,57.3,2176795,1982829,193966,8.9,SC
47,2008,Dec,62.9,56.9,2178566,1972839,205727,9.4,SC
48,2009,Jan,62.8,56.5,2179478,1961864,217614,10.0,SC
49,2009,Feb,62.8,56.2,2179540,1950864,228676,10.5,SC
50,2009,Mar,62.7,55.8,2178899,1941313,237586,10.9,SC
51,2009,Apr,62.6,55.6,2177493,1933791,243702,11.2,SC
52,2009,May,62.4,55.3,2175091,1927529,247562,11.4,SC
53,2009,Jun,62.3,55.1,2171786,1921622,250164,11.5,SC
54,2009,Jul,62.1,54.8,2167514,1915174,252340,11.6,SC
55,2009,Aug,61.8,54.6,2162403,1907931,254472,11.8,SC
56,2009,Sep,61.6,54.3,2157433,1900913,256520,11.9,SC
57,2009,Oct,61.5,54.1,2153550,1895357,258193,12.0,SC
58,2009,Nov,61.3,54.0,2151877,1892604,259273,12.0,SC
59,2009,Dec,61.3,53.9,2153079,1893602,259477,12.1,SC
60,2010,Jan,61.4,54.0,2156723,1898449,258274,12.0,SC
61,2010,Feb,61.5,54.2,2161383,1905694,255689,11.8,SC
62,2010,Mar,61.5,54.4,2165917,1913417,252500,11.7,SC
63,2010,Apr,60.8,53.8,2169966,1920582,249384,11.5,SC
64,2010,May,60.9,54.0,2173188,1926827,246361,11.3,SC
65,2010,Jun,60.9,54.0,2175384,1931588,243796,11.2,SC
66,2010,Jul,60.9,54.1,2177246,1934931,242315,11.1,SC
67,2010,Aug,60.9,54.1,2179221,1937521,241700,11.1,SC
68,2010,Sep,60.9,54.1,2180881,1939615,241266,11.1,SC
69,2010,Oct,60.8,54.1,2182059,1941633,240426,11.0,SC
70,2010,Nov,60.8,54.1,2182565,1943658,238907,10.9,SC
71,2010,Dec,60.7,54.1,2182283,1945344,236939,10.9,SC
72,2011,Jan,60.7,54.1,2181867,1946678,235189,10.8,SC
73,2011,Feb,60.6,54.1,2181732,1947628,234104,10.7,SC
74,2011,Mar,60.6,54.1,2181809,1948272,233537,10.7,SC
75,2011,Apr,60.6,54.1,2182071,1948677,233394,10.7,SC
76,2011,May,60.5,54.1,2182996,1949399,233597,10.7,SC
77,2011,Jun,60.5,54.1,2184648,1951312,233336,10.7,SC
78,2011,Jul,60.5,54.1,2186574,1954830,231744,10.6,SC
79,2011,Aug,60.5,54.2,2188150,1959427,228723,10.5,SC
80,2011,Sep,60.5,54.3,2189084,1964431,224653,10.3,SC
81,2011,Oct,60.4,54.3,2189390,1969230,220160,10.1,SC
82,2011,Nov,60.3,54.4,2188894,1973095,215799,9.9,SC
83,2011,Dec,60.2,54.4,2187724,1975735,211989,9.7,SC
84,2012,Jan,60.2,54.4,2186464,1977447,209017,9.6,SC
85,2012,Feb,60.1,54.4,2185903,1978893,207010,9.5,SC
86,2012,Mar,60.0,54.4,2186140,1980232,205908,9.4,SC
87,2012,Apr,60.0,54.4,2186592,1981691,204901,9.4,SC
88,2012,May,59.9,54.4,2187077,1983929,203148,9.3,SC
89,2012,Jun,59.9,54.4,2187672,1987341,200331,9.2,SC
90,2012,Jul,59.9,54.5,2188604,1991994,196610,9.0,SC
91,2012,Aug,59.8,54.6,2190380,1997580,192800,8.8,SC
92,2012,Sep,59.8,54.7,2193195,2003396,189799,8.7,SC
93,2012,Oct,59.9,54.7,2196167,2008369,187798,8.6,SC
94,2012,Nov,59.8,54.8,2198590,2011982,186608,8.5,SC
95,2012,Dec,59.8,54.8,2199962,2014398,185564,8.4,SC
96,2013,Jan,59.8,54.8,2200061,2016002,184059,8.4,SC
97,2013,Feb,59.7,54.7,2199344,2017705,181639,8.3,SC
98,2013,Mar,59.6,54.8,2198641,2020519,178122,8.1,SC
99,2013,Apr,59.5,54.8,2198847,2024897,173950,7.9,SC
100,2013,May,59.5,54.9,2199734,2029943,169791,7.7,SC
101,2013,Jun,59.5,55.0,2200680,2034640,166040,7.5,SC
102,2013,Jul,59.4,55.0,2201018,2038451,162567,7.4,SC
103,2013,Aug,59.3,55.0,2200075,2041415,158660,7.2,SC
104,2013,Sep,59.2,55.0,2197737,2043945,153792,7.0,SC
105,2013,Oct,59.0,55.0,2195205,2046797,148408,6.8,SC
106,2013,Nov,58.9,55.1,2193757,2050570,143187,6.5,SC
107,2013,Dec,58.8,55.1,2193803,2055149,138654,6.3,SC
108,2014,Jan,58.8,55.2,2195170,2060182,134988,6.1,SC
109,2014,Feb,58.8,55.3,2197611,2065174,132437,6.0,SC
110,2014,Mar,58.8,55.3,2201104,2069541,131563,6.0,SC
111,2014,Apr,58.9,55.3,2205386,2072892,132494,6.0,SC
112,2014,May,58.9,55.3,2210478,2075727,134751,6.1,SC
113,2014,Jun,59.0,55.4,2216695,2078892,137803,6.2,SC
114,2014,Jul,59.1,55.4,2223807,2082702,141105,6.3,SC
115,2014,Aug,59.3,55.4,2231509,2087391,144118,6.5,SC
116,2014,Sep,59.4,55.5,2239247,2092822,146425,6.5,SC
117,2014,Oct,59.5,55.6,2245849,2098372,147477,6.6,SC
118,2014,Nov,59.5,55.6,2250477,2103434,147043,6.5,SC
119,2014,Dec,59.5,55.7,2253950,2108022,145928,6.5,SC
120,2015,Jan,59.5,55.7,2257193,2112314,144879,6.4,SC
121,2015,Feb,59.5,55.7,2260446,2116354,144092,6.4,SC
122,2015,Mar,59.5,55.8,2263671,2120647,143024,6.3,SC
123,2015,Apr,59.5,55.8,2266502,2125329,141173,6.2,SC
124,2015,May,59.5,55.8,2268384,2129882,138502,6.1,SC
125,2015,Jun,59.4,55.9,2268969,2133764,135205,6.0,SC
126,2015,Jul,59.3,55.9,2268743,2136969,131774,5.8,SC
127,2015,Aug,59.2,55.9,2268472,2139758,128714,5.7,SC
128,2015,Sep,59.2,55.9,2268967,2142840,126127,5.6,SC
129,2015,Oct,59.1,55.9,2271292,2147013,124279,5.5,SC
130,2015,Nov,59.2,55.9,2275676,2152291,123385,5.4,SC
131,2015,Dec,59.2,56.0,2280829,2157985,122844,5.4,SC
132,2016,Jan,59.2,56.1,2285355,2163254,122101,5.3,SC
133,2016,Feb,59.2,56.1,2288411,2167393,121018,5.3,SC
134,2016,Mar,59.2,56.1,2289534,2170026,119508,5.2,SC
135,2016,Apr,59.1,56.0,2289095,2171385,117710,5.1,SC
136,2016,May,59.0,56.0,2287908,2172197,115711,5.1,SC
137,2016,Jun,58.8,55.9,2286438,2172971,113467,5.0,SC
138,2016,Jul,58.7,55.9,2285086,2174111,110975,4.9,SC
139,2016,Aug,58.6,55.8,2284243,2175693,108550,4.8,SC
140,2016,Sep,58.5,55.8,2284053,2177396,106657,4.7,SC
141,2016,Oct,58.5,55.8,2284227,2179118,105109,4.6,SC
142,2016,Nov,58.4,55.8,2284792,2181286,103506,4.5,SC
143,2016,Dec,58.3,55.8,2285947,2184139,101808,4.5,SC
144,2017,Jan,58.2,55.6,2253968,2155359,98609,4.4,SC
145,2017,Feb,58.2,55.7,2255750,2158908,96842,4.3,SC
146,2017,Mar,58.2,55.7,2257873,2162564,95309,4.2,SC
147,2017,Apr,58.2,55.7,2260249,2166033,94216,4.2,SC
148,2017,May,58.1,55.7,2262759,2169130,93629,4.1,SC
149,2017,Jun,58.1,55.7,2265091,2171395,93696,4.1,SC
150,2017,Jul,58.1,55.7,2266673,2172303,94370,4.2,SC
151,2017,Aug,58.1,55.6,2266940,2171730,95210,4.2,SC
152,2017,Sep,58.0,55.5,2265919,2170172,95747,4.2,SC
153,2017,Oct,57.9,55.4,2264088,2168436,95652,4.2,SC
154,2017,Nov,57.7,55.3,2261774,2167270,94504,4.2,SC
155,2017,Dec,57.6,55.3,2259641,2167809,91832,4.1,SC
156,2018,Jan,57.5,55.3,2258710,2170870,87840,3.9,SC
157,2018,Feb,57.5,55.4,2259903,2176667,83236,3.7,SC
158,2018,Mar,57.5,55.5,2263172,2184301,78871,3.5,SC
159,2018,Apr,57.6,55.7,2267395,2191811,75584,3.3,SC
160,2018,May,57.6,55.8,2271621,2197624,73997,3.3,SC
161,2018,Jun,57.7,55.8,2275744,2201713,74031,3.3,SC
162,2018,Jul,57.7,55.8,2279814,2204853,74961,3.3,SC
163,2018,Aug,57.8,55.8,2284172,2208194,75978,3.3,SC
164,2018,Sep,57.8,55.9,2288764,2212365,76399,3.3,SC
165,2018,Oct,57.9,55.9,2293685,2217627,76058,3.3,SC
166,2018,Nov,57.9,56.0,2299253,2223867,75386,3.3,SC
167,2018,Dec,58.0,56.1,2305641,2230706,74935,3.3,SC
168,2019,Jan,58.1,56.2,2312177,2237422,74755,3.2,SC
169,2019,Feb,58.2,56.3,2317929,2243502,74427,3.2,SC
170,2019,Mar,58.3,56.4,2322331,2248777,73554,3.2,SC
171,2019,Apr,58.3,56.5,2325150,2253580,71570,3.1,SC
172,2019,May,58.2,56.5,2326050,2257737,68313,2.9,SC
173,2019,Jun,58.1,56.5,2325118,2260740,64378,2.8,SC
174,2019,Jul,58.0,56.5,2322974,2262293,60681,2.6,SC
175,2019,Aug,57.9,56.4,2320621,2262647,57974,2.5,SC
176,2019,Sep,57.8,56.4,2319582,2262962,56620,2.4,SC
177,2019,Oct,57.7,56.3,2320285,2263409,56876,2.5,SC
178,2019,Nov,57.7,56.2,2321943,2263505,58438,2.5,SC
179,2019,Dec,57.6,56.1,2322544,2261611,60933,2.6,SC
180,2020,Jan,57.5,55.9,2320747,2256818,63929,2.8,SC
181,2020,Feb,57.4,55.7,2316473,2249353,67120,2.9,SC
182,2020,Mar,57.2,55.4,2311188,2241107,70081,3.0,SC
183,2020,Apr,57.1,50.5,2310569,2042032,268537,11.6,SC
184,2020,May,57.3,52.1,2322657,2110422,212235,9.1,SC
185,2020,Jun,57.2,52.7,2318617,2137279,181338,7.8,SC
186,2020,Jul,57.4,53.3,2331860,2165093,166767,7.2,SC
187,2020,Aug,57.5,53.9,2336650,2189153,147497,6.3,SC
188,2020,Sep,57.7,54.3,2346034,2208782,137252,5.9,SC
189,2020,Oct,57.6,54.5,2347401,2221881,125520,5.3,SC
190,2020,Nov,57.6,54.7,2349304,2230215,119089,5.1,SC
191,2020,Dec,57.6,54.7,2350683,2235662,115021,4.9,SC
192,2021,Jan,57.5,54.8,2349601,2240667,108934,4.6,SC
193,2021,Feb,57.4,54.9,2350945,2246531,104414,4.4,SC
194,2021,Mar,57.5,55.0,2355006,2253648,101358,4.3,SC
195,2021,Apr,57.5,55.1,2360039,2260720,99319,4.2,SC
196,2021,May,57.6,55.2,2364470,2266546,97924,4.1,SC
197,2021,Jun,57.6,55.2,2367554,2270209,97345,4.1,SC
198,2021,Jul,57.5,55.2,2368671,2273275,95396,4.0,SC
199,2021,Aug,57.4,55.2,2369185,2276348,92837,3.9,SC
200,2021,Sep,57.4,55.2,2369616,2280234,89382,3.8,SC
201,2021,Oct,57.3,55.2,2370730,2284207,86523,3.6,SC
202,2021,Nov,57.2,55.2,2371116,2285949,85167,3.6,SC
203,2021,Dec,57.1,55.1,2371298,2286561,84737,3.6,SC
204,2022,Jan,57.1,55.2,2374542,2292300,82242,3.5,SC
205,2022,Feb,57.2,55.2,2378347,2295733,82614,3.5,SC
206,2022,Mar,57.2,55.3,2384346,2303599,80747,3.4,SC
207,2022,Apr,57.3,55.4,2391819,2312654,79165,3.3,SC
208,2022,May,57.5,55.6,2401098,2321969,79129,3.3,SC
209,2022,Jun,57.5,55.6,2404186,2326245,77941,3.2,SC
210,2022,Jul,57.3,55.4,2399624,2323963,75661,3.2,SC
211,2022,Aug,57.0,55.3,2394720,2320199,74521,3.1,SC
212,2022,Sep,56.9,55.1,2391226,2315822,75404,3.2,SC
213,2022,Oct,56.7,54.8,2386456,2307897,78559,3.3,SC
214,2022,Nov,56.4,54.6,2380754,2302601,78153,3.3,SC
0,2005,Jan,66.3,63.1,555142,528431,26711,4.8,RI
1,2005,Feb,66.5,63.2,556396,529447,26949,4.8,RI
2,2005,Mar,66.6,63.4,557823,530675,27148,4.9,RI
3,2005,Apr,66.9,63.6,559468,532093,27375,4.9,RI
4,2005,May,67.1,63.8,561332,533579,27753,4.9,RI
5,2005,Jun,67.3,63.9,563275,534939,28336,5.0,RI
6,2005,Jul,67.5,64.1,565147,536047,29100,5.1,RI
7,2005,Aug,67.7,64.2,566774,536885,29889,5.3,RI
8,2005,Sep,67.9,64.2,567997,537478,30519,5.4,RI
9,2005,Oct,67.9,64.2,568714,537884,30830,5.4,RI
10,2005,Nov,67.9,64.2,568990,538164,30826,5.4,RI
11,2005,Dec,67.9,64.3,569041,538397,30644,5.4,RI
12,2006,Jan,67.9,64.3,569149,538717,30432,5.3,RI
13,2006,Feb,68.0,64.4,569485,539189,30296,5.3,RI
14,2006,Mar,68.1,64.4,570038,539718,30320,5.3,RI
15,2006,Apr,68.1,64.5,570682,540218,30464,5.3,RI
16,2006,May,68.2,64.6,571288,540727,30561,5.3,RI
17,2006,Jun,68.3,64.6,571775,541227,30548,5.3,RI
18,2006,Jul,68.3,64.7,572139,541730,30409,5.3,RI
19,2006,Aug,68.4,64.8,572453,542291,30162,5.3,RI
20,2006,Sep,68.4,64.8,572774,542951,29823,5.2,RI
21,2006,Oct,68.4,64.9,573073,543752,29321,5.1,RI
22,2006,Nov,68.4,65.0,573244,544562,28682,5.0,RI
23,2006,Dec,68.4,65.1,573158,545163,27995,4.9,RI
24,2007,Jan,68.4,65.1,572807,545438,27369,4.8,RI
25,2007,Feb,68.3,65.1,572300,545375,26925,4.7,RI
26,2007,Mar,68.3,65.1,571668,544930,26738,4.7,RI
27,2007,Apr,68.2,65.0,570999,544147,26852,4.7,RI
28,2007,May,68.1,64.9,570461,543171,27290,4.8,RI
29,2007,Jun,68.1,64.8,570163,542213,27950,4.9,RI
30,2007,Jul,68.1,64.7,570143,541420,28723,5.0,RI
31,2007,Aug,68.1,64.6,570405,540790,29615,5.2,RI
32,2007,Sep,68.1,64.5,570798,540203,30595,5.4,RI
33,2007,Oct,68.2,64.4,571100,539446,31654,5.5,RI
34,2007,Nov,68.2,64.3,571118,538458,32660,5.7,RI
35,2007,Dec,68.1,64.1,570736,537218,33518,5.9,RI
36,2008,Jan,68.0,63.9,569965,535641,34324,6.0,RI
37,2008,Feb,67.9,63.7,569022,533834,35188,6.2,RI
38,2008,Mar,67.8,63.5,568244,531970,36274,6.4,RI
39,2008,Apr,67.8,63.3,567825,530113,37712,6.6,RI
40,2008,May,67.8,63.0,567747,528239,39508,7.0,RI
41,2008,Jun,67.8,62.8,567899,526367,41532,7.3,RI
42,2008,Jul,67.8,62.6,568073,524490,43583,7.7,RI
43,2008,Aug,67.8,62.3,568078,522550,45528,8.0,RI
44,2008,Sep,67.7,62.1,567986,520521,47465,8.4,RI
45,2008,Oct,67.7,61.8,568036,518421,49615,8.7,RI
46,2008,Nov,67.7,61.5,568403,516233,52170,9.2,RI
47,2008,Dec,67.8,61.2,569129,513987,55142,9.7,RI
48,2009,Jan,67.9,60.9,570102,511798,58304,10.2,RI
49,2009,Feb,68.0,60.7,571173,509825,61348,10.7,RI
50,2009,Mar,68.1,60.5,572186,508335,63851,11.2,RI
51,2009,Apr,68.1,60.3,572945,507414,65531,11.4,RI
52,2009,May,68.1,60.3,573225,506814,66411,11.6,RI
53,2009,Jun,68.1,60.2,572988,506299,66689,11.6,RI
54,2009,Jul,68.0,60.1,572299,505661,66638,11.6,RI
55,2009,Aug,67.8,59.9,571336,504843,66493,11.6,RI
56,2009,Sep,67.7,59.8,570350,503932,66418,11.6,RI
57,2009,Oct,67.6,59.7,569553,503064,66489,11.7,RI
58,2009,Nov,67.5,59.6,569272,502515,66757,11.7,RI
59,2009,Dec,67.5,59.6,569708,502523,67185,11.8,RI
60,2010,Jan,67.6,59.6,570682,503082,67600,11.8,RI
61,2010,Feb,67.8,59.7,571720,503913,67807,11.9,RI
62,2010,Mar,67.8,59.8,572495,504735,67760,11.8,RI
63,2010,Apr,68.2,60.1,572934,505463,67471,11.8,RI
64,2010,May,68.1,60.2,573007,506076,66931,11.7,RI
65,2010,Jun,68.0,60.2,572722,506386,66336,11.6,RI
66,2010,Jul,67.9,60.1,572214,506297,65917,11.5,RI
67,2010,Aug,67.8,60.0,571663,505931,65732,11.5,RI
68,2010,Sep,67.7,60.0,571043,505366,65677,11.5,RI
69,2010,Oct,67.6,59.9,570297,504726,65571,11.5,RI
70,2010,Nov,67.5,59.8,569337,504107,65230,11.5,RI
71,2010,Dec,67.4,59.7,568158,503571,64587,11.4,RI
72,2011,Jan,67.2,59.6,566951,503187,63764,11.2,RI
73,2011,Feb,67.1,59.6,565786,502846,62940,11.1,RI
74,2011,Mar,66.9,59.5,564558,502337,62221,11.0,RI
75,2011,Apr,66.8,59.4,563251,501528,61723,11.0,RI
76,2011,May,66.6,59.3,562055,500504,61551,11.0,RI
77,2011,Jun,66.5,59.2,561130,499522,61608,11.0,RI
78,2011,Jul,66.4,59.1,560553,498806,61747,11.0,RI
79,2011,Aug,66.3,59.0,560271,498401,61870,11.0,RI
80,2011,Sep,66.3,59.0,560162,498282,61880,11.0,RI
81,2011,Oct,66.2,59.0,560083,498375,61708,11.0,RI
82,2011,Nov,66.2,58.9,559786,498474,61312,11.0,RI
83,2011,Dec,66.1,58.9,559195,498490,60705,10.9,RI
84,2012,Jan,66.0,58.9,558445,498475,59970,10.7,RI
85,2012,Feb,65.9,58.9,557824,498546,59278,10.6,RI
86,2012,Mar,65.8,58.9,557571,498778,58793,10.5,RI
87,2012,Apr,65.8,58.9,557728,499229,58499,10.5,RI
88,2012,May,65.9,59.0,558373,500092,58281,10.4,RI
89,2012,Jun,66.0,59.1,559379,501371,58008,10.4,RI
90,2012,Jul,66.1,59.3,560517,502970,57547,10.3,RI
91,2012,Aug,66.2,59.5,561632,504721,56911,10.1,RI
92,2012,Sep,66.3,59.7,562634,506423,56211,10.0,RI
93,2012,Oct,66.3,59.8,563279,507798,55481,9.8,RI
94,2012,Nov,66.3,59.9,563414,508614,54800,9.7,RI
95,2012,Dec,66.3,59.9,562969,508737,54232,9.6,RI
96,2013,Jan,66.1,59.8,562023,508212,53811,9.6,RI
97,2013,Feb,66.0,59.7,560911,507392,53519,9.5,RI
98,2013,Mar,65.9,59.6,559931,506604,53327,9.5,RI
99,2013,Apr,65.8,59.5,559297,506046,53251,9.5,RI
100,2013,May,65.7,59.5,558940,505643,53297,9.5,RI
101,2013,Jun,65.7,59.4,558786,505369,53417,9.6,RI
102,2013,Jul,65.7,59.4,558732,505219,53513,9.6,RI
103,2013,Aug,65.6,59.3,558488,505098,53390,9.6,RI
104,2013,Sep,65.5,59.3,557966,505026,52940,9.5,RI
105,2013,Oct,65.4,59.3,557392,505095,52297,9.4,RI
106,2013,Nov,65.4,59.3,556987,505441,51546,9.3,RI
107,2013,Dec,65.3,59.4,556785,506086,50699,9.1,RI
108,2014,Jan,65.3,59.5,556711,507010,49701,8.9,RI
109,2014,Feb,65.3,59.6,556646,508127,48519,8.7,RI
110,2014,Mar,65.3,59.7,556615,509375,47240,8.5,RI
111,2014,Apr,65.3,59.9,556609,510641,45968,8.3,RI
112,2014,May,65.2,60.0,556598,511878,44720,8.0,RI
113,2014,Jun,65.2,60.1,556619,513087,43532,7.8,RI
114,2014,Jul,65.2,60.2,556618,514189,42429,7.6,RI
115,2014,Aug,65.2,60.3,556677,515271,41406,7.4,RI
116,2014,Sep,65.2,60.4,556814,516395,40419,7.3,RI
117,2014,Oct,65.2,60.6,556941,517546,39395,7.1,RI
118,2014,Nov,65.2,60.7,557010,518689,38321,6.9,RI
119,2014,Dec,65.2,60.8,557152,519822,37330,6.7,RI
120,2015,Jan,65.2,60.9,557431,520872,36559,6.6,RI
121,2015,Feb,65.2,61.0,557723,521694,36029,6.5,RI
122,2015,Mar,65.2,61.1,557822,522242,35580,6.4,RI
123,2015,Apr,65.2,61.1,557557,522512,35045,6.3,RI
124,2015,May,65.1,61.1,556870,522512,34358,6.2,RI
125,2015,Jun,65.0,61.0,555818,522251,33567,6.0,RI
126,2015,Jul,64.8,61.0,554698,521895,32803,5.9,RI
127,2015,Aug,64.7,60.9,553720,521546,32174,5.8,RI
128,2015,Sep,64.6,60.9,552928,521239,31689,5.7,RI
129,2015,Oct,64.5,60.8,552438,521094,31344,5.7,RI
130,2015,Nov,64.5,60.8,552327,521203,31124,5.6,RI
131,2015,Dec,64.5,60.8,552428,521489,30939,5.6,RI
132,2016,Jan,64.5,60.9,552571,521873,30698,5.6,RI
133,2016,Feb,64.5,60.9,552733,522325,30408,5.5,RI
134,2016,Mar,64.5,61.0,552908,522805,30103,5.4,RI
135,2016,Apr,64.5,61.0,553110,523270,29840,5.4,RI
136,2016,May,64.5,61.0,553362,523706,29656,5.4,RI
137,2016,Jun,64.5,61.1,553581,524123,29458,5.3,RI
138,2016,Jul,64.5,61.1,553639,524516,29123,5.3,RI
139,2016,Aug,64.5,61.1,553585,524930,28655,5.2,RI
140,2016,Sep,64.5,61.2,553591,525454,28137,5.1,RI
141,2016,Oct,64.5,61.3,553696,526126,27570,5.0,RI
142,2016,Nov,64.5,61.3,553934,526963,26971,4.9,RI
143,2016,Dec,64.5,61.5,554336,527979,26357,4.8,RI
144,2017,Jan,64.3,61.3,566288,540023,26265,4.6,RI
145,2017,Feb,64.4,61.5,566807,541089,25718,4.5,RI
146,2017,Mar,64.4,61.5,567226,541886,25340,4.5,RI
147,2017,Apr,64.4,61.6,567546,542434,25112,4.4,RI
148,2017,May,64.4,61.6,567818,542809,25009,4.4,RI
149,2017,Jun,64.4,61.6,568094,543011,25083,4.4,RI
150,2017,Jul,64.4,61.6,568432,543089,25343,4.5,RI
151,2017,Aug,64.4,61.5,568723,543076,25647,4.5,RI
152,2017,Sep,64.4,61.5,568878,542976,25902,4.6,RI
153,2017,Oct,64.4,61.4,568910,542867,26043,4.6,RI
154,2017,Nov,64.3,61.4,568872,542833,26039,4.6,RI
155,2017,Dec,64.3,61.4,568957,543131,25826,4.5,RI
156,2018,Jan,64.3,61.4,569323,543936,25387,4.5,RI
157,2018,Feb,64.4,61.6,570047,545295,24752,4.3,RI
158,2018,Mar,64.4,61.7,571006,546964,24042,4.2,RI
159,2018,Apr,64.5,61.9,571882,548476,23406,4.1,RI
160,2018,May,64.5,61.9,572394,549460,22934,4.0,RI
161,2018,Jun,64.5,62.0,572502,549846,22656,4.0,RI
162,2018,Jul,64.4,61.9,572236,549668,22568,3.9,RI
163,2018,Aug,64.4,61.8,571787,549143,22644,4.0,RI
164,2018,Sep,64.3,61.7,571315,548556,22759,4.0,RI
165,2018,Oct,64.2,61.6,570886,548133,22753,4.0,RI
166,2018,Nov,64.1,61.6,570481,547946,22535,4.0,RI
167,2018,Dec,64.1,61.6,570031,547966,22065,3.9,RI
168,2019,Jan,64.0,61.6,569526,548130,21396,3.8,RI
169,2019,Feb,63.9,61.6,569077,548452,20625,3.6,RI
170,2019,Mar,63.9,61.6,568917,548954,19963,3.5,RI
171,2019,Apr,63.9,61.7,569259,549676,19583,3.4,RI
172,2019,May,64.0,61.8,570111,550557,19554,3.4,RI
173,2019,Jun,64.1,61.9,571391,551537,19854,3.5,RI
174,2019,Jul,64.2,62.0,572914,552569,20345,3.6,RI
175,2019,Aug,64.4,62.0,574351,553569,20782,3.6,RI
176,2019,Sep,64.4,62.1,575412,554568,20844,3.6,RI
177,2019,Oct,64.5,62.2,576021,555379,20642,3.6,RI
178,2019,Nov,64.5,62.2,576172,555744,20428,3.5,RI
179,2019,Dec,64.4,62.1,575641,555168,20473,3.6,RI
180,2020,Jan,64.2,61.9,574242,553451,20791,3.6,RI
181,2020,Feb,63.9,61.6,571812,550807,21005,3.7,RI
182,2020,Mar,63.5,61.2,568277,547596,20681,3.6,RI
183,2020,Apr,61.0,49.8,546360,446095,100265,18.4,RI
184,2020,May,63.6,53.7,569790,481072,88718,15.6,RI
185,2020,Jun,63.6,55.0,569386,492500,76886,13.5,RI
186,2020,Jul,64.0,56.2,572963,502979,69984,12.2,RI
187,2020,Aug,63.5,57.0,569195,511008,58187,10.2,RI
188,2020,Sep,63.9,57.8,572684,517575,55109,9.6,RI
189,2020,Oct,62.5,58.2,560504,521896,38608,6.9,RI
190,2020,Nov,62.9,58.6,563622,525037,38585,6.8,RI
191,2020,Dec,63.1,58.8,565478,527526,37952,6.7,RI
192,2021,Jan,63.1,59.1,565572,529936,35636,6.3,RI
193,2021,Feb,63.2,59.4,567075,532386,34689,6.1,RI
194,2021,Mar,63.4,59.6,568817,534768,34049,6.0,RI
195,2021,Apr,63.7,59.9,571428,536799,34629,6.1,RI
196,2021,May,63.8,60.0,572637,538315,34322,6.0,RI
197,2021,Jun,64.0,60.1,574739,539247,35492,6.2,RI
198,2021,Jul,64.0,60.1,574777,540006,34771,6.0,RI
199,2021,Aug,63.9,60.2,574243,540775,33468,5.8,RI
200,2021,Sep,63.7,60.3,572690,541840,30850,5.4,RI
201,2021,Oct,63.6,60.4,571546,542981,28565,5.0,RI
202,2021,Nov,63.4,60.4,570298,543578,26720,4.7,RI
203,2021,Dec,63.3,60.4,569597,543856,25741,4.5,RI
204,2022,Jan,63.2,60.5,568890,544901,23989,4.2,RI
205,2022,Feb,63.2,60.7,568599,546254,22345,3.9,RI
206,2022,Mar,63.2,61.0,568894,549326,19568,3.4,RI
207,2022,Apr,63.2,61.2,569045,551011,18034,3.2,RI
208,2022,May,63.3,61.4,570116,553614,16502,2.9,RI
209,2022,Jun,63.4,61.7,571935,556208,15727,2.7,RI
210,2022,Jul,63.6,61.9,573306,557967,15339,2.7,RI
211,2022,Aug,63.7,61.9,575093,558745,16348,2.8,RI
212,2022,Sep,63.9,61.9,576830,559147,17683,3.1,RI
213,2022,Oct,63.9,61.8,577629,558100,19529,3.4,RI
214,2022,Nov,63.8,61.5,576728,556097,20631,3.6,RI
0,2005,Jan,65.5,61.7,17439739,16435427,1004312,5.8,CA
1,2005,Feb,65.5,61.7,17455416,16463071,992345,5.7,CA
2,2005,Mar,65.5,61.8,17473771,16495869,977902,5.6,CA
3,2005,Apr,65.5,61.9,17496205,16533791,962414,5.5,CA
4,2005,May,65.6,62.0,17522524,16574980,947544,5.4,CA
5,2005,Jun,65.6,62.1,17548901,16613194,935707,5.3,CA
6,2005,Jul,65.7,62.2,17571326,16642343,928983,5.3,CA
7,2005,Aug,65.7,62.2,17586567,16660840,925727,5.3,CA
8,2005,Sep,65.6,62.2,17593070,16670184,922886,5.2,CA
9,2005,Oct,65.5,62.1,17592258,16675256,917002,5.2,CA
10,2005,Nov,65.4,62.0,17588199,16680410,907789,5.2,CA
11,2005,Dec,65.3,62.0,17583772,16687569,896203,5.1,CA
12,2006,Jan,65.3,62.0,17582550,16698861,883689,5.0,CA
13,2006,Feb,65.3,62.0,17587038,16714377,872661,5.0,CA
14,2006,Mar,65.3,62.1,17596774,16730993,865781,4.9,CA
15,2006,Apr,65.3,62.1,17609415,16745349,864066,4.9,CA
16,2006,May,65.3,62.1,17622725,16757871,864854,4.9,CA
17,2006,Jun,65.3,62.1,17635569,16770248,865321,4.9,CA
18,2006,Jul,65.4,62.2,17650474,16786840,863634,4.9,CA
19,2006,Aug,65.4,62.2,17671419,16810113,861306,4.9,CA
20,2006,Sep,65.4,62.2,17699166,16838653,860513,4.9,CA
21,2006,Oct,65.5,62.3,17731148,16870354,860794,4.9,CA
22,2006,Nov,65.5,62.4,17763499,16900814,862685,4.9,CA
23,2006,Dec,65.6,62.4,17791249,16924622,866627,4.9,CA
24,2007,Jan,65.6,62.4,17811829,16938382,873447,4.9,CA
25,2007,Feb,65.6,62.4,17826788,16943822,882966,5.0,CA
26,2007,Mar,65.6,62.3,17837732,16944145,893587,5.0,CA
27,2007,Apr,65.6,62.3,17848998,16944007,904991,5.1,CA
28,2007,May,65.6,62.2,17864179,16945471,918708,5.1,CA
29,2007,Jun,65.6,62.2,17884308,16949426,934882,5.2,CA
30,2007,Jul,65.7,62.2,17909056,16955401,953655,5.3,CA
31,2007,Aug,65.7,62.1,17937431,16962173,975258,5.4,CA
32,2007,Sep,65.7,62.1,17966927,16969958,996969,5.5,CA
33,2007,Oct,65.7,62.0,17993950,16976329,1017621,5.7,CA
34,2007,Nov,65.8,62.0,18015561,16980264,1035297,5.7,CA
35,2007,Dec,65.8,61.9,18032573,16982149,1050424,5.8,CA
36,2008,Jan,65.7,61.8,18047064,16979728,1067336,5.9,CA
37,2008,Feb,65.7,61.8,18061461,16972015,1089446,6.0,CA
38,2008,Mar,65.7,61.7,18079489,16958869,1120620,6.2,CA
39,2008,Apr,65.8,61.5,18102490,16940096,1162394,6.4,CA
40,2008,May,65.8,61.4,18131133,16917726,1213407,6.7,CA
41,2008,Jun,65.8,61.2,18164654,16894388,1270266,7.0,CA
42,2008,Jul,65.9,61.1,18198631,16869967,1328664,7.3,CA
43,2008,Aug,65.9,60.9,18229614,16841893,1387721,7.6,CA
44,2008,Sep,66.0,60.7,18257580,16805122,1452458,8.0,CA
45,2008,Oct,66.0,60.5,18283764,16755408,1528356,8.4,CA
46,2008,Nov,66.0,60.2,18307599,16691191,1616408,8.8,CA
47,2008,Dec,66.0,59.8,18327303,16614367,1712936,9.3,CA
48,2009,Jan,66.0,59.5,18341252,16530013,1811239,9.9,CA
49,2009,Feb,66.0,59.1,18350557,16445664,1904893,10.4,CA
50,2009,Mar,65.9,58.8,18357115,16370975,1986140,10.8,CA
51,2009,Apr,65.9,58.5,18360253,16310052,2050201,11.2,CA
52,2009,May,65.8,58.3,18356368,16257221,2099147,11.4,CA
53,2009,Jun,65.7,58.0,18344271,16206712,2137559,11.7,CA
54,2009,Jul,65.6,57.8,18323390,16154640,2168750,11.8,CA
55,2009,Aug,65.4,57.5,18295071,16100602,2194469,12.0,CA
56,2009,Sep,65.2,57.3,18266064,16049842,2216222,12.1,CA
57,2009,Oct,65.0,57.1,18243355,16007637,2235718,12.3,CA
58,2009,Nov,64.9,56.9,18237262,15981193,2256069,12.4,CA
59,2009,Dec,64.9,56.8,18254035,15975922,2278113,12.5,CA
60,2010,Jan,65.0,56.8,18288466,15991766,2296700,12.6,CA
61,2010,Feb,65.1,56.9,18327194,16020128,2307066,12.6,CA
62,2010,Mar,65.1,56.9,18359589,16050996,2308593,12.6,CA
63,2010,Apr,64.4,56.3,18381603,16078778,2302825,12.5,CA
64,2010,May,64.4,56.4,18391244,16101040,2290204,12.5,CA
65,2010,Jun,64.3,56.4,18389824,16113195,2276629,12.4,CA
66,2010,Jul,64.2,56.3,18384037,16113653,2270384,12.3,CA
67,2010,Aug,64.2,56.2,18380281,16106916,2273365,12.4,CA
68,2010,Sep,64.1,56.1,18378828,16097746,2281082,12.4,CA
69,2010,Oct,64.0,56.0,18378713,16092500,2286213,12.4,CA
70,2010,Nov,63.9,56.0,18376501,16093722,2282779,12.4,CA
71,2010,Dec,63.8,56.0,18370136,16100812,2269324,12.4,CA
72,2011,Jan,63.8,55.9,18363805,16113386,2250419,12.3,CA
73,2011,Feb,63.7,55.9,18359121,16127796,2231325,12.2,CA
74,2011,Mar,63.6,55.9,18354669,16139805,2214864,12.1,CA
75,2011,Apr,63.6,55.9,18352428,16147585,2204843,12.0,CA
76,2011,May,63.5,55.9,18358639,16155067,2203572,12.0,CA
77,2011,Jun,63.5,55.9,18375161,16169321,2205840,12.0,CA
78,2011,Jul,63.5,55.9,18400252,16196030,2204222,12.0,CA
79,2011,Aug,63.6,56.0,18428801,16234039,2194762,11.9,CA
80,2011,Sep,63.6,56.1,18453635,16277760,2175875,11.8,CA
81,2011,Oct,63.6,56.2,18470587,16320810,2149777,11.6,CA
82,2011,Nov,63.5,56.2,18475806,16356584,2119222,11.5,CA
83,2011,Dec,63.4,56.3,18469241,16381644,2087597,11.3,CA
84,2012,Jan,63.3,56.3,18456650,16397835,2058815,11.2,CA
85,2012,Feb,63.2,56.3,18447162,16411184,2035978,11.0,CA
86,2012,Mar,63.2,56.3,18445792,16424830,2020962,11.0,CA
87,2012,Apr,63.1,56.3,18449665,16440520,2009145,10.9,CA
88,2012,May,63.1,56.3,18457489,16462781,1994708,10.8,CA
89,2012,Jun,63.1,56.3,18468110,16494261,1973849,10.7,CA
90,2012,Jul,63.1,56.4,18479876,16534689,1945187,10.5,CA
91,2012,Aug,63.0,56.5,18494681,16581684,1912997,10.3,CA
92,2012,Sep,63.0,56.6,18515366,16631825,1883541,10.2,CA
93,2012,Oct,63.1,56.7,18536565,16678616,1857949,10.0,CA
94,2012,Nov,63.0,56.8,18553309,16717341,1835968,9.9,CA
95,2012,Dec,63.0,56.9,18562700,16747321,1815379,9.8,CA
96,2013,Jan,63.0,56.9,18564212,16769858,1794354,9.7,CA
97,2013,Feb,62.9,56.9,18561589,16789624,1771965,9.5,CA
98,2013,Mar,62.9,56.9,18560032,16812502,1747530,9.4,CA
99,2013,Apr,62.8,57.0,18565682,16842626,1723056,9.3,CA
100,2013,May,62.8,57.0,18576563,16874399,1702164,9.2,CA
101,2013,Jun,62.8,57.1,18587359,16900895,1686464,9.1,CA
102,2013,Jul,62.7,57.1,18593103,16919448,1673655,9.0,CA
103,2013,Aug,62.7,57.1,18587188,16930930,1656258,8.9,CA
104,2013,Sep,62.5,57.0,18570217,16939401,1630816,8.8,CA
105,2013,Oct,62.4,57.0,18553825,16951113,1602712,8.6,CA
106,2013,Nov,62.3,57.0,18547876,16971722,1576154,8.5,CA
107,2013,Dec,62.3,57.1,18554149,17001882,1552267,8.4,CA
108,2014,Jan,62.3,57.2,18569356,17040259,1529097,8.2,CA
109,2014,Feb,62.3,57.3,18588369,17083487,1504882,8.1,CA
110,2014,Mar,62.3,57.4,18608224,17126546,1481678,8.0,CA
111,2014,Apr,62.3,57.4,18624963,17164661,1460302,7.8,CA
112,2014,May,62.3,57.5,18638929,17200175,1438754,7.7,CA
113,2014,Jun,62.3,57.6,18656005,17238675,1417330,7.6,CA
114,2014,Jul,62.3,57.7,18677566,17279967,1397599,7.5,CA
115,2014,Aug,62.3,57.7,18704813,17324005,1380808,7.4,CA
116,2014,Sep,62.4,57.8,18735234,17369795,1365439,7.3,CA
117,2014,Oct,62.4,57.9,18760622,17413762,1346860,7.2,CA
118,2014,Nov,62.4,58.0,18775765,17451977,1323788,7.1,CA
119,2014,Dec,62.4,58.0,18785368,17484592,1300776,6.9,CA
120,2015,Jan,62.3,58.1,18794302,17513360,1280942,6.8,CA
121,2015,Feb,62.3,58.1,18804573,17539526,1265047,6.7,CA
122,2015,Mar,62.3,58.2,18816299,17566611,1249688,6.6,CA
123,2015,Apr,62.3,58.2,18826398,17594659,1231739,6.5,CA
124,2015,May,62.3,58.3,18830333,17620363,1209970,6.4,CA
125,2015,Jun,62.2,58.3,18825613,17640900,1184713,6.3,CA
126,2015,Jul,62.1,58.3,18816836,17658045,1158791,6.2,CA
127,2015,Aug,62.0,58.3,18810236,17674840,1135396,6.0,CA
128,2015,Sep,62.0,58.3,18810658,17695331,1115327,5.9,CA
129,2015,Oct,62.0,58.4,18824385,17724466,1099919,5.8,CA
130,2015,Nov,62.0,58.4,18852382,17762494,1089888,5.8,CA
131,2015,Dec,62.1,58.5,18886247,17804150,1082097,5.7,CA
132,2016,Jan,62.1,58.6,18917326,17843140,1074186,5.7,CA
133,2016,Feb,62.2,58.7,18941962,17875645,1066317,5.6,CA
134,2016,Mar,62.2,58.7,18959258,17901022,1058236,5.6,CA
135,2016,Apr,62.2,58.7,18973207,17921613,1051594,5.5,CA
136,2016,May,62.2,58.8,18989520,17941250,1048270,5.5,CA
137,2016,Jun,62.2,58.8,19008579,17961187,1047392,5.5,CA
138,2016,Jul,62.2,58.8,19028074,17981056,1047018,5.5,CA
139,2016,Aug,62.2,58.8,19046039,17999607,1046432,5.5,CA
140,2016,Sep,62.2,58.8,19061155,18015129,1046026,5.5,CA
141,2016,Oct,62.2,58.8,19071727,18028383,1043344,5.5,CA
142,2016,Nov,62.2,58.8,19079948,18044658,1035290,5.4,CA
143,2016,Dec,62.2,58.9,19090083,18068401,1021682,5.4,CA
144,2017,Jan,62.2,58.9,19107737,18104833,1002904,5.2,CA
145,2017,Feb,62.2,59.0,19127260,18143666,983594,5.1,CA
146,2017,Mar,62.3,59.1,19149284,18183179,966105,5.0,CA
147,2017,Apr,62.3,59.2,19172412,18220082,952330,5.0,CA
148,2017,May,62.4,59.3,19193658,18252450,941208,4.9,CA
149,2017,Jun,62.4,59.4,19209913,18277837,932076,4.9,CA
150,2017,Jul,62.4,59.4,19220058,18295974,924084,4.8,CA
151,2017,Aug,62.3,59.4,19221629,18307232,914397,4.8,CA
152,2017,Sep,62.3,59.4,19215041,18312935,902106,4.7,CA
153,2017,Oct,62.2,59.3,19204052,18316581,887471,4.6,CA
154,2017,Nov,62.2,59.3,19193135,18320848,872287,4.5,CA
155,2017,Dec,62.1,59.3,19189000,18331881,857119,4.5,CA
156,2018,Jan,62.1,59.4,19198144,18354112,844032,4.4,CA
157,2018,Feb,62.2,59.5,19223127,18389120,834007,4.3,CA
158,2018,Mar,62.3,59.6,19257396,18431283,826113,4.3,CA
159,2018,Apr,62.4,59.7,19287831,18468594,819237,4.2,CA
160,2018,May,62.4,59.8,19305583,18491362,814221,4.2,CA
161,2018,Jun,62.4,59.8,19310277,18499191,811086,4.2,CA
162,2018,Jul,62.3,59.7,19305159,18495803,809356,4.2,CA
163,2018,Aug,62.3,59.7,19299752,18488583,811169,4.2,CA
164,2018,Sep,62.3,59.6,19300343,18483342,817001,4.2,CA
165,2018,Oct,62.3,59.6,19308507,18483737,824770,4.3,CA
166,2018,Nov,62.3,59.6,19321690,18490160,831530,4.3,CA
167,2018,Dec,62.3,59.6,19335749,18501839,833910,4.3,CA
168,2019,Jan,62.4,59.7,19346362,18516404,829958,4.3,CA
169,2019,Feb,62.4,59.7,19351682,18532272,819410,4.2,CA
170,2019,Mar,62.4,59.8,19354512,18548250,806262,4.2,CA
171,2019,Apr,62.4,59.8,19360091,18566280,793811,4.1,CA
172,2019,May,62.4,59.9,19369999,18584927,785072,4.1,CA
173,2019,Jun,62.4,59.9,19383861,18601627,782234,4.0,CA
174,2019,Jul,62.5,59.9,19400003,18615002,785001,4.0,CA
175,2019,Aug,62.5,60.0,19417606,18628076,789530,4.1,CA
176,2019,Sep,62.6,60.0,19440418,18649671,790747,4.1,CA
177,2019,Oct,62.6,60.1,19471434,18680037,791397,4.1,CA
178,2019,Nov,62.7,60.2,19507623,18714185,793438,4.1,CA
179,2019,Dec,62.8,60.3,19535597,18738543,797054,4.1,CA
180,2020,Jan,62.8,60.3,19545409,18744753,800656,4.1,CA
181,2020,Feb,62.8,60.2,19536350,18733837,802513,4.1,CA
182,2020,Mar,61.9,58.6,19267549,18213641,1053908,5.5,CA
183,2020,Apr,60.0,50.4,18651174,15685944,2965230,15.9,CA
184,2020,May,59.8,50.2,18606506,15604432,3002074,16.1,CA
185,2020,Jun,61.2,52.6,19042530,16365183,2677347,14.1,CA
186,2020,Jul,61.3,53.1,19059395,16506245,2553150,13.4,CA
187,2020,Aug,60.7,53.4,18869585,16616651,2252934,11.9,CA
188,2020,Sep,60.0,53.8,18666533,16740763,1925770,10.3,CA
189,2020,Oct,59.8,54.1,18584660,16820478,1764182,9.5,CA
190,2020,Nov,59.8,54.3,18600782,16892595,1708187,9.2,CA
191,2020,Dec,60.1,54.6,18670917,16957946,1712971,9.2,CA
192,2021,Jan,60.1,54.8,18657907,17020492,1637415,8.8,CA
193,2021,Feb,60.3,55.1,18706712,17099131,1607581,8.6,CA
194,2021,Mar,60.5,55.4,18781662,17199917,1581745,8.4,CA
195,2021,Apr,60.9,55.8,18881824,17310628,1571196,8.3,CA
196,2021,May,61.0,56.2,18913379,17414749,1498630,7.9,CA
197,2021,Jun,61.3,56.5,19021240,17517358,1503882,7.9,CA
198,2021,Jul,61.3,56.8,19016323,17609627,1406696,7.4,CA
199,2021,Aug,61.4,57.1,19049309,17709087,1340222,7.0,CA
200,2021,Sep,61.3,57.4,19006826,17788720,1218106,6.4,CA
201,2021,Oct,61.4,57.6,19024355,17860812,1163543,6.1,CA
202,2021,Nov,61.2,57.6,18963995,17860281,1103714,5.8,CA
203,2021,Dec,61.1,57.6,18946015,17850959,1095056,5.8,CA
204,2022,Jan,61.5,58.0,19048755,17959101,1089654,5.7,CA
205,2022,Feb,61.5,58.3,19068225,18056231,1011994,5.3,CA
206,2022,Mar,61.7,58.7,19124991,18198059,926932,4.8,CA
207,2022,Apr,62.1,59.2,19229150,18348193,880957,4.6,CA
208,2022,May,62.3,59.6,19298832,18469509,829323,4.3,CA
209,2022,Jun,62.5,59.9,19350182,18544716,805466,4.2,CA
210,2022,Jul,62.4,60.0,19323052,18568488,754564,3.9,CA
211,2022,Aug,62.5,60.0,19348044,18564222,783822,4.1,CA
212,2022,Sep,62.3,59.9,19284590,18543364,741226,3.8,CA
213,2022,Oct,62.3,59.8,19275395,18503094,772301,4.0,CA
214,2022,Nov,62.2,59.6,19254439,18460375,794064,4.1,CA
0,2005,Jan,68.5,65.3,2900672,2763621,137051,4.7,MD
1,2005,Feb,68.6,65.3,2905808,2768164,137644,4.7,MD
2,2005,Mar,68.7,65.5,2912173,2774885,137288,4.7,MD
3,2005,Apr,68.8,65.6,2919397,2783419,135978,4.7,MD
4,2005,May,68.9,65.8,2926886,2792868,134018,4.6,MD
5,2005,Jun,69.0,65.9,2933604,2801630,131974,4.5,MD
6,2005,Jul,69.1,66.0,2938910,2808520,130390,4.4,MD
7,2005,Aug,69.1,66.1,2942753,2813495,129258,4.4,MD
8,2005,Sep,69.1,66.1,2945531,2817311,128220,4.4,MD
9,2005,Oct,69.0,66.1,2947984,2821340,126644,4.3,MD
10,2005,Nov,69.1,66.1,2950992,2826553,124439,4.2,MD
11,2005,Dec,69.1,66.2,2954859,2832771,122088,4.1,MD
12,2006,Jan,69.1,66.3,2959519,2839370,120149,4.1,MD
13,2006,Feb,69.2,66.4,2964849,2845544,119305,4.0,MD
14,2006,Mar,69.3,66.5,2970542,2850446,120096,4.0,MD
15,2006,Apr,69.4,66.6,2976119,2853647,122472,4.1,MD
16,2006,May,69.5,66.6,2981172,2855605,125567,4.2,MD
17,2006,Jun,69.6,66.6,2985290,2857042,128248,4.3,MD
18,2006,Jul,69.6,66.6,2988845,2859174,129671,4.3,MD
19,2006,Aug,69.6,66.6,2992402,2862631,129771,4.3,MD
20,2006,Sep,69.7,66.7,2995782,2866926,128856,4.3,MD
21,2006,Oct,69.7,66.7,2998354,2871256,127098,4.2,MD
22,2006,Nov,69.6,66.7,2999434,2874673,124761,4.2,MD
23,2006,Dec,69.6,66.7,2998285,2876346,121939,4.1,MD
24,2007,Jan,69.5,66.7,2994895,2875951,118944,4.0,MD
25,2007,Feb,69.3,66.6,2990228,2874136,116092,3.9,MD
26,2007,Mar,69.2,66.5,2985200,2871826,113374,3.8,MD
27,2007,Apr,69.0,66.5,2981141,2870098,111043,3.7,MD
28,2007,May,68.9,66.4,2979361,2869725,109636,3.7,MD
29,2007,Jun,68.9,66.4,2980361,2871146,109215,3.7,MD
30,2007,Jul,69.0,66.4,2983555,2874060,109495,3.7,MD
31,2007,Aug,69.0,66.5,2987929,2877897,110032,3.7,MD
32,2007,Sep,69.1,66.5,2992773,2882585,110188,3.7,MD
33,2007,Oct,69.1,66.6,2997232,2887521,109711,3.7,MD
34,2007,Nov,69.2,66.7,3000787,2892173,108614,3.6,MD
35,2007,Dec,69.2,66.7,3003897,2896480,107417,3.6,MD
36,2008,Jan,69.2,66.8,3006981,2899910,107071,3.6,MD
37,2008,Feb,69.3,66.8,3010368,2902178,108190,3.6,MD
38,2008,Mar,69.3,66.8,3014563,2903324,111239,3.7,MD
39,2008,Apr,69.4,66.8,3019372,2903305,116067,3.8,MD
40,2008,May,69.5,66.7,3024091,2902061,122030,4.0,MD
41,2008,Jun,69.6,66.6,3028390,2899785,128605,4.2,MD
42,2008,Jul,69.6,66.5,3031959,2896505,135454,4.5,MD
43,2008,Aug,69.6,66.3,3034819,2892074,142745,4.7,MD
44,2008,Sep,69.6,66.1,3037478,2886085,151393,5.0,MD
45,2008,Oct,69.6,65.9,3040575,2878435,162140,5.3,MD
46,2008,Nov,69.6,65.6,3044184,2869411,174773,5.7,MD
47,2008,Dec,69.7,65.4,3047840,2859476,188364,6.2,MD
48,2009,Jan,69.7,65.1,3051111,2849401,201710,6.6,MD
49,2009,Feb,69.7,64.8,3053799,2840168,213631,7.0,MD
50,2009,Mar,69.7,64.6,3055887,2832928,222959,7.3,MD
51,2009,Apr,69.7,64.5,3057218,2828165,229053,7.5,MD
52,2009,May,69.6,64.3,3057191,2824833,232358,7.6,MD
53,2009,Jun,69.5,64.2,3055637,2821735,233902,7.7,MD
54,2009,Jul,69.4,64.1,3052760,2818008,234752,7.7,MD
55,2009,Aug,69.3,63.9,3048938,2813403,235535,7.7,MD
56,2009,Sep,69.1,63.7,3044831,2808298,236533,7.8,MD
57,2009,Oct,68.9,63.5,3041386,2803176,238210,7.8,MD
58,2009,Nov,68.9,63.4,3040505,2799603,240902,7.9,MD
59,2009,Dec,68.9,63.3,3043485,2799405,244080,8.0,MD
60,2010,Jan,69.0,63.4,3049772,2803421,246351,8.1,MD
61,2010,Feb,69.1,63.5,3057423,2810540,246883,8.1,MD
62,2010,Mar,69.2,63.6,3064844,2818977,245867,8.0,MD
63,2010,Apr,68.4,63.0,3071526,2827499,244027,7.9,MD
64,2010,May,68.5,63.1,3077202,2835458,241744,7.9,MD
65,2010,Jun,68.5,63.2,3081487,2841759,239728,7.8,MD
66,2010,Jul,68.5,63.2,3084531,2845807,238724,7.7,MD
67,2010,Aug,68.5,63.2,3087064,2848274,238790,7.7,MD
68,2010,Sep,68.4,63.1,3089416,2850163,239253,7.7,MD
69,2010,Oct,68.4,63.1,3091736,2852813,238923,7.7,MD
70,2010,Nov,68.4,63.1,3093338,2856158,237180,7.7,MD
71,2010,Dec,68.3,63.2,3093874,2859411,234463,7.6,MD
72,2011,Jan,68.3,63.2,3094091,2862372,231719,7.5,MD
73,2011,Feb,68.2,63.2,3094149,2864621,229528,7.4,MD
74,2011,Mar,68.2,63.1,3093519,2865617,227902,7.4,MD
75,2011,Apr,68.1,63.1,3092166,2865055,227111,7.3,MD
76,2011,May,68.0,63.0,3091054,2863648,227406,7.4,MD
77,2011,Jun,67.9,62.9,3091103,2862954,228149,7.4,MD
78,2011,Jul,67.9,62.9,3092882,2864451,228431,7.4,MD
79,2011,Aug,67.9,62.9,3096098,2868279,227819,7.4,MD
80,2011,Sep,67.9,63.0,3099892,2873749,226143,7.3,MD
81,2011,Oct,67.9,63.0,3103611,2879948,223663,7.2,MD
82,2011,Nov,67.9,63.1,3106452,2885725,220727,7.1,MD
83,2011,Dec,67.9,63.2,3107880,2890142,217738,7.0,MD
84,2012,Jan,67.9,63.2,3108021,2892744,215277,6.9,MD
85,2012,Feb,67.8,63.1,3108088,2894197,213891,6.9,MD
86,2012,Mar,67.8,63.1,3108973,2895102,213871,6.9,MD
87,2012,Apr,67.7,63.1,3110612,2895918,214694,6.9,MD
88,2012,May,67.7,63.1,3113280,2897677,215603,6.9,MD
89,2012,Jun,67.8,63.1,3116975,2900940,216035,6.9,MD
90,2012,Jul,67.8,63.1,3121317,2905634,215683,6.9,MD
91,2012,Aug,67.9,63.2,3126121,2911289,214832,6.9,MD
92,2012,Sep,67.9,63.3,3131152,2917104,214048,6.8,MD
93,2012,Oct,67.9,63.3,3135207,2921744,213463,6.8,MD
94,2012,Nov,67.9,63.3,3137652,2924538,213114,6.8,MD
95,2012,Dec,67.9,63.3,3138497,2925667,212830,6.8,MD
96,2013,Jan,67.9,63.3,3138015,2925435,212580,6.8,MD
97,2013,Feb,67.8,63.2,3136770,2924605,212165,6.8,MD
98,2013,Mar,67.7,63.2,3135411,2924180,211231,6.7,MD
99,2013,Apr,67.7,63.2,3134729,2925125,209604,6.7,MD
100,2013,May,67.6,63.1,3134344,2926541,207803,6.6,MD
101,2013,Jun,67.6,63.1,3133645,2927329,206316,6.6,MD
102,2013,Jul,67.5,63.1,3132042,2927100,204942,6.5,MD
103,2013,Aug,67.4,63.0,3128842,2925935,202907,6.5,MD
104,2013,Sep,67.2,62.9,3124472,2924492,199980,6.4,MD
105,2013,Oct,67.1,62.9,3120510,2923641,196869,6.3,MD
106,2013,Nov,67.0,62.8,3118057,2924041,194016,6.2,MD
107,2013,Dec,67.0,62.9,3117158,2925695,191463,6.1,MD
108,2014,Jan,66.9,62.9,3117343,2928422,188921,6.1,MD
109,2014,Feb,66.9,62.9,3118114,2931696,186418,6.0,MD
110,2014,Mar,66.9,63.0,3119340,2934794,184546,5.9,MD
111,2014,Apr,66.9,63.0,3120501,2937114,183387,5.9,MD
112,2014,May,66.9,63.0,3121400,2939236,182164,5.8,MD
113,2014,Jun,66.9,63.0,3122644,2942245,180399,5.8,MD
114,2014,Jul,66.9,63.1,3124415,2946042,178373,5.7,MD
115,2014,Aug,66.9,63.1,3126888,2950361,176527,5.6,MD
116,2014,Sep,66.9,63.2,3129613,2954694,174919,5.6,MD
117,2014,Oct,66.9,63.2,3131723,2958485,173238,5.5,MD
118,2014,Nov,66.9,63.2,3132751,2961418,171333,5.5,MD
119,2014,Dec,66.9,63.3,3133445,2963878,169567,5.4,MD
120,2015,Jan,66.9,63.3,3134640,2966550,168090,5.4,MD
121,2015,Feb,66.9,63.3,3136563,2969832,166731,5.3,MD
122,2015,Mar,66.9,63.4,3139033,2974094,164939,5.3,MD
123,2015,Apr,66.9,63.5,3141417,2978798,162619,5.2,MD
124,2015,May,66.9,63.5,3142923,2982840,160083,5.1,MD
125,2015,Jun,66.9,63.6,3142915,2985301,157614,5.0,MD
126,2015,Jul,66.9,63.5,3141732,2986335,155397,4.9,MD
127,2015,Aug,66.8,63.5,3140095,2986765,153330,4.9,MD
128,2015,Sep,66.7,63.5,3138851,2987744,151107,4.8,MD
129,2015,Oct,66.7,63.6,3139081,2990357,148724,4.7,MD
130,2015,Nov,66.7,63.6,3141039,2994693,146346,4.7,MD
131,2015,Dec,66.8,63.7,3143703,2999779,143924,4.6,MD
132,2016,Jan,66.8,63.8,3145817,3004440,141377,4.5,MD
133,2016,Feb,66.8,63.9,3146807,3007840,138967,4.4,MD
134,2016,Mar,66.8,63.9,3146772,3009911,136861,4.3,MD
135,2016,Apr,66.8,63.9,3146561,3011264,135297,4.3,MD
136,2016,May,66.8,63.9,3147271,3012872,134399,4.3,MD
137,2016,Jun,66.8,64.0,3149300,3015276,134024,4.3,MD
138,2016,Jul,66.9,64.0,3152707,3018813,133894,4.2,MD
139,2016,Aug,66.9,64.1,3157347,3023343,134004,4.2,MD
140,2016,Sep,67.0,64.2,3162687,3028270,134417,4.3,MD
141,2016,Oct,67.1,64.2,3167854,3033190,134664,4.3,MD
142,2016,Nov,67.2,64.3,3172830,3038452,134378,4.2,MD
143,2016,Dec,67.2,64.4,3177879,3044323,133556,4.2,MD
144,2017,Jan,67.3,64.6,3221638,3089758,131880,4.1,MD
145,2017,Feb,67.4,64.7,3226867,3097289,129578,4.0,MD
146,2017,Mar,67.5,64.8,3231923,3104255,127668,4.0,MD
147,2017,Apr,67.5,64.9,3237141,3110578,126563,3.9,MD
148,2017,May,67.6,65.0,3242668,3116341,126327,3.9,MD
149,2017,Jun,67.7,65.1,3248037,3121014,127023,3.9,MD
150,2017,Jul,67.8,65.1,3252578,3124032,128546,4.0,MD
151,2017,Aug,67.8,65.1,3255258,3124951,130307,4.0,MD
152,2017,Sep,67.8,65.0,3255786,3123986,131800,4.0,MD
153,2017,Oct,67.7,64.9,3254560,3121982,132578,4.1,MD
154,2017,Nov,67.6,64.9,3252112,3119773,132339,4.1,MD
155,2017,Dec,67.5,64.8,3249421,3118863,130558,4.0,MD
156,2018,Jan,67.5,64.8,3247795,3120450,127345,3.9,MD
157,2018,Feb,67.5,64.9,3248403,3124980,123423,3.8,MD
158,2018,Mar,67.5,65.0,3251233,3131430,119803,3.7,MD
159,2018,Apr,67.6,65.1,3254698,3137389,117309,3.6,MD
160,2018,May,67.6,65.2,3257325,3140910,116415,3.6,MD
161,2018,Jun,67.6,65.2,3258941,3142186,116755,3.6,MD
162,2018,Jul,67.6,65.1,3259888,3142300,117588,3.6,MD
163,2018,Aug,67.6,65.1,3261540,3142975,118565,3.6,MD
164,2018,Sep,67.6,65.1,3264849,3145393,119456,3.7,MD
165,2018,Oct,67.7,65.2,3269993,3150167,119826,3.7,MD
166,2018,Nov,67.8,65.3,3276596,3157213,119383,3.6,MD
167,2018,Dec,67.9,65.5,3283426,3165854,117572,3.6,MD
168,2019,Jan,68.0,65.6,3289198,3175100,114098,3.5,MD
169,2019,Feb,68.1,65.8,3293614,3184213,109401,3.3,MD
170,2019,Mar,68.1,66.0,3297747,3192591,105156,3.2,MD
171,2019,Apr,68.2,66.1,3303285,3200287,102998,3.1,MD
172,2019,May,68.4,66.2,3310991,3207154,103837,3.1,MD
173,2019,Jun,68.5,66.3,3320467,3212917,107550,3.2,MD
174,2019,Jul,68.7,66.4,3330576,3217531,113045,3.4,MD
175,2019,Aug,68.9,66.4,3339997,3221500,118497,3.5,MD
176,2019,Sep,69.0,66.5,3348286,3226265,122021,3.6,MD
177,2019,Oct,69.1,66.6,3355823,3231811,124012,3.7,MD
178,2019,Nov,69.3,66.7,3362833,3237048,125785,3.7,MD
179,2019,Dec,69.4,66.7,3369249,3239835,129414,3.8,MD
180,2020,Jan,69.5,66.7,3374532,3239178,135354,4.0,MD
181,2020,Feb,69.5,66.6,3376242,3235420,140822,4.2,MD
182,2020,Mar,69.4,66.5,3372956,3231372,141584,4.2,MD
183,2020,Apr,65.9,59.7,3204088,2900236,303852,9.5,MD
184,2020,May,66.1,59.8,3212451,2908400,304051,9.5,MD
185,2020,Jun,65.6,60.0,3189403,2916380,273023,8.6,MD
186,2020,Jul,65.7,60.4,3191646,2932874,258772,8.1,MD
187,2020,Aug,65.3,60.6,3172053,2943961,228092,7.2,MD
188,2020,Sep,65.2,60.8,3170591,2954426,216165,6.8,MD
189,2020,Oct,64.8,60.8,3151947,2956469,195478,6.2,MD
190,2020,Nov,64.8,60.8,3149220,2958056,191164,6.1,MD
191,2020,Dec,64.9,60.8,3156185,2958733,197452,6.3,MD
192,2021,Jan,64.7,60.9,3146320,2959403,186917,5.9,MD
193,2021,Feb,64.6,60.9,3142049,2961596,180453,5.7,MD
194,2021,Mar,64.7,61.0,3146948,2967803,179145,5.7,MD
195,2021,Apr,64.9,61.2,3153668,2974474,179194,5.7,MD
196,2021,May,65.0,61.3,3161565,2981461,180104,5.7,MD
197,2021,Jun,65.4,61.4,3181841,2986557,195284,6.1,MD
198,2021,Jul,65.5,61.5,3185455,2991736,193719,6.1,MD
199,2021,Aug,65.7,61.6,3197512,2999568,197944,6.2,MD
200,2021,Sep,65.5,61.8,3190434,3006593,183841,5.8,MD
201,2021,Oct,65.7,61.9,3197771,3014642,183129,5.7,MD
202,2021,Nov,65.5,61.9,3189172,3016016,173156,5.4,MD
203,2021,Dec,65.4,61.9,3187023,3015271,171752,5.4,MD
204,2022,Jan,65.6,62.1,3196602,3025349,171253,5.4,MD
205,2022,Feb,65.5,62.3,3194561,3035369,159192,5.0,MD
206,2022,Mar,65.6,62.5,3198014,3049888,148126,4.6,MD
207,2022,Apr,65.5,62.8,3196817,3063427,133390,4.2,MD
208,2022,May,65.7,63.0,3203096,3075534,127562,4.0,MD
209,2022,Jun,65.9,63.2,3215074,3085336,129738,4.0,MD
210,2022,Jul,65.8,63.3,3212804,3088040,124764,3.9,MD
211,2022,Aug,66.1,63.2,3226267,3088160,138107,4.3,MD
212,2022,Sep,65.7,63.1,3211994,3083683,128311,4.0,MD
213,2022,Oct,65.9,62.9,3220478,3075726,144752,4.5,MD
214,2022,Nov,65.6,62.7,3205498,3067845,137653,4.3,MD
0,2005,Jan,66.2,62.3,4307787,4059887,247900,5.8,NC
1,2005,Feb,66.2,62.4,4315872,4068033,247839,5.7,NC
2,2005,Mar,66.2,62.4,4323537,4076344,247193,5.7,NC
3,2005,Apr,66.2,62.5,4330675,4084487,246188,5.7,NC
4,2005,May,66.2,62.5,4338048,4092837,245211,5.7,NC
5,2005,Jun,66.2,62.5,4346067,4101399,244668,5.6,NC
6,2005,Jul,66.3,62.5,4354216,4109401,244815,5.6,NC
7,2005,Aug,66.3,62.5,4361901,4116952,244949,5.6,NC
8,2005,Sep,66.2,62.5,4368733,4124674,244059,5.6,NC
9,2005,Oct,66.1,62.5,4374131,4132785,241346,5.5,NC
10,2005,Nov,66.1,62.5,4378685,4141686,236999,5.4,NC
11,2005,Dec,66.0,62.5,4383727,4152043,231684,5.3,NC
12,2006,Jan,66.0,62.6,4390556,4164193,226363,5.2,NC
13,2006,Feb,66.0,62.7,4400107,4177906,222201,5.0,NC
14,2006,Mar,66.1,62.8,4412606,4192361,220245,5.0,NC
15,2006,Apr,66.2,62.9,4427027,4205992,221035,5.0,NC
16,2006,May,66.3,62.9,4441640,4217778,223862,5.0,NC
17,2006,Jun,66.4,63.0,4455650,4227934,227716,5.1,NC
18,2006,Jul,66.5,63.0,4469761,4238151,231610,5.2,NC
19,2006,Aug,66.5,63.1,4483993,4248964,235029,5.2,NC
20,2006,Sep,66.6,63.1,4497305,4259872,237433,5.3,NC
21,2006,Oct,66.6,63.1,4508874,4271262,237612,5.3,NC
22,2006,Nov,66.6,63.1,4517303,4281978,235325,5.2,NC
23,2006,Dec,66.5,63.1,4521187,4289779,231408,5.1,NC
24,2007,Jan,66.4,63.1,4521375,4294318,227057,5.0,NC
25,2007,Feb,66.3,63.0,4519599,4296091,223508,4.9,NC
26,2007,Mar,66.1,62.9,4517170,4295713,221457,4.9,NC
27,2007,Apr,65.9,62.7,4516257,4294922,221335,4.9,NC
28,2007,May,65.8,62.6,4518158,4294750,223408,4.9,NC
29,2007,Jun,65.8,62.5,4522298,4295160,227138,5.0,NC
30,2007,Jul,65.7,62.4,4527639,4295905,231734,5.1,NC
31,2007,Aug,65.7,62.3,4533684,4297291,236393,5.2,NC
32,2007,Sep,65.7,62.2,4539861,4299964,239897,5.3,NC
33,2007,Oct,65.6,62.2,4545177,4303422,241755,5.3,NC
34,2007,Nov,65.6,62.1,4548881,4307399,241482,5.3,NC
35,2007,Dec,65.5,62.1,4550690,4311456,239234,5.3,NC
36,2008,Jan,65.4,62.0,4550387,4313877,236510,5.2,NC
37,2008,Feb,65.3,61.9,4549021,4313948,235073,5.2,NC
38,2008,Mar,65.2,61.8,4548589,4312032,236557,5.2,NC
39,2008,Apr,65.1,61.7,4550328,4308779,241549,5.3,NC
40,2008,May,65.1,61.5,4555179,4305858,249321,5.5,NC
41,2008,Jun,65.1,61.4,4562466,4304212,258254,5.7,NC
42,2008,Jul,65.1,61.3,4570040,4303689,266351,5.8,NC
43,2008,Aug,65.1,61.2,4575725,4302733,272992,6.0,NC
44,2008,Sep,65.1,61.1,4578761,4298716,280045,6.1,NC
45,2008,Oct,65.0,60.9,4579559,4289462,290097,6.3,NC
46,2008,Nov,66.0,60.4,4660713,4261029,399684,8.6,NC
47,2008,Dec,66.2,59.8,4675867,4227952,447915,9.6,NC
48,2009,Jan,66.0,59.3,4671579,4192895,478684,10.2,NC
49,2009,Feb,65.8,58.7,4661739,4159541,502198,10.8,NC
50,2009,Mar,65.6,58.3,4650196,4131549,518647,11.2,NC
51,2009,Apr,65.3,57.9,4637538,4110725,526813,11.4,NC
52,2009,May,65.1,57.7,4628915,4101862,527053,11.4,NC
53,2009,Jun,64.7,57.4,4604881,4083417,521464,11.3,NC
54,2009,Jul,64.5,57.3,4597934,4084669,513265,11.2,NC
55,2009,Aug,64.4,57.3,4589848,4084287,505561,11.0,NC
56,2009,Sep,64.2,57.2,4583348,4082693,500655,10.9,NC
57,2009,Oct,64.1,57.1,4580404,4080565,499839,10.9,NC
58,2009,Nov,64.1,57.0,4583521,4080299,503222,11.0,NC
59,2009,Dec,64.2,57.1,4594002,4084559,509443,11.1,NC
60,2010,Jan,64.3,57.1,4610346,4094353,515993,11.2,NC
61,2010,Feb,64.5,57.3,4627749,4107826,519923,11.2,NC
62,2010,Mar,64.7,57.4,4641281,4122130,519151,11.2,NC
63,2010,Apr,63.7,56.7,4647554,4134333,513221,11.0,NC
64,2010,May,63.6,56.7,4645967,4142800,503167,10.8,NC
65,2010,Jun,63.4,56.7,4639128,4147049,492079,10.6,NC
66,2010,Jul,63.2,56.6,4631078,4147718,483360,10.4,NC
67,2010,Aug,63.0,56.5,4625433,4146285,479148,10.4,NC
68,2010,Sep,62.9,56.4,4623661,4144357,479304,10.4,NC
69,2010,Oct,62.9,56.3,4626410,4144561,481849,10.4,NC
70,2010,Nov,62.9,56.3,4631812,4147506,484306,10.5,NC
71,2010,Dec,62.9,56.3,4636964,4152239,484725,10.5,NC
72,2011,Jan,62.9,56.4,4640615,4157931,482684,10.4,NC
73,2011,Feb,62.9,56.4,4642589,4163486,479103,10.3,NC
74,2011,Mar,62.8,56.4,4643342,4167826,475516,10.2,NC
75,2011,Apr,62.8,56.4,4644273,4170634,473639,10.2,NC
76,2011,May,62.8,56.4,4646793,4172192,474601,10.2,NC
77,2011,Jun,62.8,56.3,4650932,4173283,477649,10.3,NC
78,2011,Jul,62.8,56.3,4656313,4175330,480983,10.3,NC
79,2011,Aug,62.8,56.3,4662440,4179593,482847,10.4,NC
80,2011,Sep,62.8,56.3,4668641,4186860,481781,10.3,NC
81,2011,Oct,62.8,56.4,4674451,4196794,477657,10.2,NC
82,2011,Nov,62.8,56.5,4679145,4208165,470980,10.1,NC
83,2011,Dec,62.8,56.6,4682632,4219676,462956,9.9,NC
84,2012,Jan,62.8,56.7,4685349,4230281,455068,9.7,NC
85,2012,Feb,62.7,56.7,4687985,4239253,448732,9.6,NC
86,2012,Mar,62.7,56.8,4690963,4245775,445188,9.5,NC
87,2012,Apr,62.7,56.8,4694447,4250182,444265,9.5,NC
88,2012,May,62.7,56.8,4699826,4254632,445194,9.5,NC
89,2012,Jun,62.8,56.8,4708084,4261249,446835,9.5,NC
90,2012,Jul,62.9,56.9,4718993,4270883,448110,9.5,NC
91,2012,Aug,63.0,57.0,4731208,4282400,448808,9.5,NC
92,2012,Sep,63.0,57.1,4743200,4293726,449474,9.5,NC
93,2012,Oct,63.1,57.1,4752900,4302880,450020,9.5,NC
94,2012,Nov,63.1,57.1,4758979,4308809,450170,9.5,NC
95,2012,Dec,63.1,57.1,4761413,4311658,449755,9.4,NC
96,2013,Jan,63.0,57.1,4761137,4312086,449051,9.4,NC
97,2013,Feb,62.7,57.0,4743684,4311836,431848,9.1,NC
98,2013,Mar,62.5,57.0,4728352,4313036,415316,8.8,NC
99,2013,Apr,62.3,57.0,4716914,4317396,399518,8.5,NC
100,2013,May,62.1,57.0,4708233,4324012,384221,8.2,NC
101,2013,Jun,61.9,57.1,4700202,4331352,368850,7.8,NC
102,2013,Jul,61.7,57.1,4691444,4338744,352700,7.5,NC
103,2013,Aug,61.6,57.1,4688961,4346556,342405,7.3,NC
104,2013,Sep,61.3,57.2,4667427,4354108,313319,6.7,NC
105,2013,Oct,61.2,57.2,4668675,4360357,308318,6.6,NC
106,2013,Nov,61.2,57.2,4669501,4365537,303964,6.5,NC
107,2013,Dec,61.2,57.2,4671157,4370197,300960,6.4,NC
108,2014,Jan,61.1,57.2,4674182,4375293,298889,6.4,NC
109,2014,Feb,61.1,57.3,4678328,4381465,296863,6.3,NC
110,2014,Mar,61.1,57.3,4683224,4388272,294952,6.3,NC
111,2014,Apr,61.1,57.3,4687746,4394339,293407,6.3,NC
112,2014,May,61.1,57.3,4691864,4399972,291892,6.2,NC
113,2014,Jun,61.1,57.4,4696574,4406318,290256,6.2,NC
114,2014,Jul,61.1,57.4,4701014,4412779,288235,6.1,NC
115,2014,Aug,61.1,57.4,4705145,4419198,285947,6.1,NC
116,2014,Sep,61.1,57.4,4709906,4426731,283175,6.0,NC
117,2014,Oct,61.1,57.5,4715147,4435823,279324,5.9,NC
118,2014,Nov,61.1,57.5,4719503,4444742,274761,5.8,NC
119,2014,Dec,61.1,57.6,4723623,4452536,271087,5.7,NC
120,2015,Jan,61.1,57.6,4728780,4459141,269639,5.7,NC
121,2015,Feb,61.1,57.6,4735727,4464853,270874,5.7,NC
122,2015,Mar,61.1,57.6,4744251,4470715,273536,5.8,NC
123,2015,Apr,61.2,57.6,4753189,4477145,276044,5.8,NC
124,2015,May,61.2,57.7,4760636,4483514,277122,5.8,NC
125,2015,Jun,61.2,57.7,4765102,4489001,276101,5.8,NC
126,2015,Jul,61.2,57.7,4767689,4494279,273410,5.7,NC
127,2015,Aug,61.1,57.7,4769911,4500058,269853,5.7,NC
128,2015,Sep,61.1,57.7,4772715,4506791,265924,5.6,NC
129,2015,Oct,61.0,57.7,4778016,4515716,262300,5.5,NC
130,2015,Nov,61.1,57.8,4787250,4527769,259481,5.4,NC
131,2015,Dec,61.2,57.9,4798884,4541877,257007,5.4,NC
132,2016,Jan,61.2,58.0,4810316,4555925,254391,5.3,NC
133,2016,Feb,61.3,58.1,4819869,4568181,251688,5.2,NC
134,2016,Mar,61.3,58.1,4826578,4577708,248870,5.2,NC
135,2016,Apr,61.3,58.1,4830974,4584798,246176,5.1,NC
136,2016,May,61.2,58.1,4834712,4590267,244445,5.1,NC
137,2016,Jun,61.2,58.1,4838912,4594881,244031,5.0,NC
138,2016,Jul,61.2,58.1,4844325,4599901,244424,5.0,NC
139,2016,Aug,61.2,58.1,4851158,4605874,245284,5.1,NC
140,2016,Sep,61.2,58.1,4859201,4612759,246442,5.1,NC
141,2016,Oct,61.2,58.1,4867434,4620450,246984,5.1,NC
142,2016,Nov,61.3,58.2,4875090,4629236,245854,5.0,NC
143,2016,Dec,61.3,58.2,4882053,4639157,242896,5.0,NC
144,2017,Jan,61.2,58.3,4829626,4594840,234786,4.9,NC
145,2017,Feb,61.3,58.4,4834668,4606000,228668,4.7,NC
146,2017,Mar,61.3,58.4,4840015,4616768,223247,4.6,NC
147,2017,Apr,61.3,58.5,4847192,4627549,219643,4.5,NC
148,2017,May,61.3,58.6,4856677,4638960,217717,4.5,NC
149,2017,Jun,61.4,58.7,4867493,4650257,217236,4.5,NC
150,2017,Jul,61.5,58.7,4878081,4660009,218072,4.5,NC
151,2017,Aug,61.5,58.7,4886091,4667119,218972,4.5,NC
152,2017,Sep,61.5,58.7,4890096,4671175,218921,4.5,NC
153,2017,Oct,61.4,58.7,4889994,4672542,217452,4.4,NC
154,2017,Nov,61.3,58.6,4887261,4672554,214707,4.4,NC
155,2017,Dec,61.2,58.6,4885076,4674384,210692,4.3,NC
156,2018,Jan,61.2,58.6,4886490,4680427,206063,4.2,NC
157,2018,Feb,61.2,58.7,4892610,4691093,201517,4.1,NC
158,2018,Mar,61.3,58.8,4901997,4704495,197502,4.0,NC
159,2018,Apr,61.3,58.9,4910919,4716490,194429,4.0,NC
160,2018,May,61.3,58.9,4916728,4723782,192946,3.9,NC
161,2018,Jun,61.3,58.9,4919386,4726499,192887,3.9,NC
162,2018,Jul,61.2,58.8,4919403,4725570,193833,3.9,NC
163,2018,Aug,61.1,58.7,4919292,4723506,195786,4.0,NC
164,2018,Sep,61.1,58.6,4921767,4723581,198186,4.0,NC
165,2018,Oct,61.1,58.6,4928050,4728084,199966,4.1,NC
166,2018,Nov,61.2,58.7,4937623,4737343,200280,4.1,NC
167,2018,Dec,61.3,58.8,4949079,4750287,198792,4.0,NC
168,2019,Jan,61.3,58.9,4960321,4764419,195902,3.9,NC
169,2019,Feb,61.4,59.0,4969520,4777552,191968,3.9,NC
170,2019,Mar,61.4,59.1,4976568,4788047,188521,3.8,NC
171,2019,Apr,61.5,59.2,4982764,4795974,186790,3.7,NC
172,2019,May,61.5,59.2,4989154,4801744,187410,3.8,NC
173,2019,Jun,61.5,59.2,4996347,4806146,190201,3.8,NC
174,2019,Jul,61.5,59.2,5004337,4810332,194005,3.9,NC
175,2019,Aug,61.6,59.2,5012227,4815228,196999,3.9,NC
176,2019,Sep,61.6,59.2,5019344,4822073,197271,3.9,NC
177,2019,Oct,61.6,59.2,5025413,4830115,195298,3.9,NC
178,2019,Nov,61.6,59.2,5029919,4837494,192425,3.8,NC
179,2019,Dec,61.5,59.2,5030284,4840332,189952,3.8,NC
180,2020,Jan,61.4,59.1,5026126,4837918,188208,3.7,NC
181,2020,Feb,61.3,59.0,5020329,4832700,187629,3.7,NC
182,2020,Mar,58.6,56.3,4803784,4617934,185850,3.9,NC
183,2020,Apr,56.7,48.6,4647617,3988923,658694,14.2,NC
184,2020,May,58.2,51.5,4778243,4230550,547693,11.5,NC
185,2020,Jun,58.2,52.6,4782193,4322081,460112,9.6,NC
186,2020,Jul,58.6,53.6,4823362,4410635,412727,8.6,NC
187,2020,Aug,58.6,54.4,4827226,4478821,348405,7.2,NC
188,2020,Sep,58.9,55.0,4850629,4534755,315874,6.5,NC
189,2020,Oct,58.8,55.4,4852850,4570276,282574,5.8,NC
190,2020,Nov,58.9,55.6,4868848,4596386,272462,5.6,NC
191,2020,Dec,59.1,55.8,4889860,4615246,274614,5.6,NC
192,2021,Jan,59.2,56.0,4898261,4630473,267788,5.5,NC
193,2021,Feb,59.3,56.1,4907319,4644505,262814,5.4,NC
194,2021,Mar,59.4,56.2,4919387,4661350,258037,5.2,NC
195,2021,Apr,59.5,56.4,4932016,4679512,252504,5.1,NC
196,2021,May,59.6,56.6,4945544,4698253,247291,5.0,NC
197,2021,Jun,59.7,56.7,4961219,4713996,247223,5.0,NC
198,2021,Jul,59.7,56.8,4971983,4729562,242421,4.9,NC
199,2021,Aug,59.8,56.9,4983772,4746664,237108,4.8,NC
200,2021,Sep,59.8,57.1,4990202,4763469,226733,4.5,NC
201,2021,Oct,59.8,57.2,4997228,4779257,217971,4.4,NC
202,2021,Nov,59.7,57.2,4994770,4784132,210638,4.2,NC
203,2021,Dec,59.6,57.1,4991732,4784669,207063,4.1,NC
204,2022,Jan,59.7,57.3,5007104,4809689,197415,3.9,NC
205,2022,Feb,59.7,57.5,5015299,4828116,187183,3.7,NC
206,2022,Mar,59.8,57.7,5030509,4853244,177265,3.5,NC
207,2022,Apr,60.1,58.0,5056492,4883161,173331,3.4,NC
208,2022,May,60.4,58.4,5087349,4916458,170891,3.4,NC
209,2022,Jun,60.5,58.4,5101330,4929061,172269,3.4,NC
210,2022,Jul,60.6,58.5,5115079,4943422,171657,3.4,NC
211,2022,Aug,60.6,58.5,5124349,4944828,179521,3.5,NC
212,2022,Sep,60.6,58.4,5128100,4943919,184181,3.6,NC
213,2022,Oct,60.5,58.2,5127986,4933905,194081,3.8,NC
214,2022,Nov,60.4,58.0,5126047,4925524,200523,3.9,NC
0,2005,Jan,71.1,67.9,1613752,1540278,73474,4.6,IA
1,2005,Feb,71.2,68.0,1616939,1544054,72885,4.5,IA
2,2005,Mar,71.3,68.2,1620079,1547950,72129,4.5,IA
3,2005,Apr,71.5,68.3,1623189,1551978,71211,4.4,IA
4,2005,May,71.6,68.5,1626381,1556181,70200,4.3,IA
5,2005,Jun,71.7,68.6,1629285,1560026,69259,4.3,IA
6,2005,Jul,71.7,68.7,1631666,1562922,68744,4.2,IA
7,2005,Aug,71.8,68.7,1633524,1564894,68630,4.2,IA
8,2005,Sep,71.8,68.8,1635007,1566429,68578,4.2,IA
9,2005,Oct,71.7,68.7,1636188,1568012,68176,4.2,IA
10,2005,Nov,71.7,68.8,1637386,1570143,67243,4.1,IA
11,2005,Dec,71.8,68.9,1639110,1573366,65744,4.0,IA
12,2006,Jan,71.9,69.1,1641849,1578060,63789,3.9,IA
13,2006,Feb,72.0,69.3,1645442,1583664,61778,3.8,IA
14,2006,Mar,72.1,69.5,1649127,1588911,60216,3.7,IA
15,2006,Apr,72.2,69.6,1652328,1592837,59491,3.6,IA
16,2006,May,72.3,69.7,1654729,1595166,59563,3.6,IA
17,2006,Jun,72.3,69.7,1656339,1596192,60147,3.6,IA
18,2006,Jul,72.3,69.7,1657590,1596824,60766,3.7,IA
19,2006,Aug,72.4,69.7,1659099,1597910,61189,3.7,IA
20,2006,Sep,72.4,69.7,1661018,1599582,61436,3.7,IA
21,2006,Oct,72.4,69.8,1662986,1601611,61375,3.7,IA
22,2006,Nov,72.4,69.8,1664385,1603265,61120,3.7,IA
23,2006,Dec,72.4,69.8,1664469,1603613,60856,3.7,IA
24,2007,Jan,72.3,69.7,1663289,1602493,60796,3.7,IA
25,2007,Feb,72.2,69.6,1661602,1600672,60930,3.7,IA
26,2007,Mar,72.1,69.5,1659975,1598932,61043,3.7,IA
27,2007,Apr,72.0,69.4,1658797,1597745,61052,3.7,IA
28,2007,May,72.0,69.3,1658248,1597178,61070,3.7,IA
29,2007,Jun,71.9,69.3,1658520,1597354,61166,3.7,IA
30,2007,Jul,72.0,69.3,1659537,1598096,61441,3.7,IA
31,2007,Aug,72.0,69.3,1661174,1599243,61931,3.7,IA
32,2007,Sep,72.0,69.3,1663352,1600949,62403,3.8,IA
33,2007,Oct,72.1,69.4,1665743,1603116,62627,3.8,IA
34,2007,Nov,72.2,69.5,1667996,1605547,62449,3.7,IA
35,2007,Dec,72.2,69.5,1670033,1608126,61907,3.7,IA
36,2008,Jan,72.2,69.6,1671514,1610160,61354,3.7,IA
37,2008,Feb,72.3,69.6,1672496,1611271,61225,3.7,IA
38,2008,Mar,72.3,69.6,1673699,1611773,61926,3.7,IA
39,2008,Apr,72.3,69.6,1675641,1612124,63517,3.8,IA
40,2008,May,72.4,69.6,1678567,1612887,65680,3.9,IA
41,2008,Jun,72.6,69.6,1682183,1614205,67978,4.0,IA
42,2008,Jul,72.7,69.6,1685651,1615698,69953,4.1,IA
43,2008,Aug,72.7,69.6,1688328,1616614,71714,4.2,IA
44,2008,Sep,72.8,69.6,1689996,1616033,73963,4.4,IA
45,2008,Oct,72.8,69.4,1690958,1613479,77479,4.6,IA
46,2008,Nov,72.7,69.2,1691223,1608748,82475,4.9,IA
47,2008,Dec,72.7,68.9,1690582,1602026,88556,5.2,IA
48,2009,Jan,72.6,68.5,1689096,1594063,95033,5.6,IA
49,2009,Feb,72.5,68.1,1687015,1585947,101068,6.0,IA
50,2009,Mar,72.3,67.8,1684717,1578852,105865,6.3,IA
51,2009,Apr,72.2,67.5,1682539,1573692,108847,6.5,IA
52,2009,May,72.1,67.4,1680503,1570351,110152,6.6,IA
53,2009,Jun,72.0,67.2,1678718,1568344,110374,6.6,IA
54,2009,Jul,71.9,67.1,1676953,1566823,110130,6.6,IA
55,2009,Aug,71.7,67.0,1674750,1565031,109719,6.6,IA
56,2009,Sep,71.5,66.9,1671946,1562768,109178,6.5,IA
57,2009,Oct,71.4,66.7,1668747,1560093,108654,6.5,IA
58,2009,Nov,71.2,66.6,1666336,1558033,108303,6.5,IA
59,2009,Dec,71.2,66.6,1666046,1557898,108148,6.5,IA
60,2010,Jan,71.2,66.6,1668161,1560395,107766,6.5,IA
61,2010,Feb,71.4,66.8,1671781,1564951,106830,6.4,IA
62,2010,Mar,71.5,67.0,1675368,1570007,105361,6.3,IA
63,2010,Apr,71.1,66.7,1677557,1573836,103721,6.2,IA
64,2010,May,71.1,66.8,1677764,1575622,102142,6.1,IA
65,2010,Jun,71.0,66.7,1676132,1575290,100842,6.0,IA
66,2010,Jul,70.9,66.6,1673866,1573698,100168,6.0,IA
67,2010,Aug,70.8,66.5,1672341,1572218,100123,6.0,IA
68,2010,Sep,70.7,66.5,1672191,1571768,100423,6.0,IA
69,2010,Oct,70.7,66.5,1673392,1572819,100573,6.0,IA
70,2010,Nov,70.8,66.5,1675189,1574964,100225,6.0,IA
71,2010,Dec,70.8,66.6,1676546,1577238,99308,5.9,IA
72,2011,Jan,70.8,66.6,1676887,1578751,98136,5.9,IA
73,2011,Feb,70.7,66.6,1676002,1579056,96946,5.8,IA
74,2011,Mar,70.6,66.5,1674053,1578220,95833,5.7,IA
75,2011,Apr,70.5,66.5,1671639,1576628,95011,5.7,IA
76,2011,May,70.3,66.3,1669479,1574841,94638,5.7,IA
77,2011,Jun,70.2,66.3,1668016,1573438,94578,5.7,IA
78,2011,Jul,70.2,66.2,1667412,1572853,94559,5.7,IA
79,2011,Aug,70.1,66.2,1667469,1573169,94300,5.7,IA
80,2011,Sep,70.1,66.2,1667811,1574205,93606,5.6,IA
81,2011,Oct,70.1,66.2,1668085,1575631,92454,5.5,IA
82,2011,Nov,70.0,66.2,1667807,1576906,90901,5.5,IA
83,2011,Dec,70.0,66.2,1666736,1577591,89145,5.3,IA
84,2012,Jan,69.9,66.2,1665187,1577773,87414,5.2,IA
85,2012,Feb,69.8,66.2,1663580,1577533,86047,5.2,IA
86,2012,Mar,69.7,66.1,1662015,1576690,85325,5.1,IA
87,2012,Apr,69.6,66.0,1660230,1575227,85003,5.1,IA
88,2012,May,69.5,65.9,1658427,1573642,84785,5.1,IA
89,2012,Jun,69.4,65.8,1657167,1572697,84470,5.1,IA
90,2012,Jul,69.3,65.8,1656736,1572880,83856,5.1,IA
91,2012,Aug,69.3,65.8,1657235,1574109,83126,5.0,IA
92,2012,Sep,69.3,65.9,1658681,1576085,82596,5.0,IA
93,2012,Oct,69.3,65.9,1660482,1578228,82254,5.0,IA
94,2012,Nov,69.4,65.9,1661913,1579766,82147,4.9,IA
95,2012,Dec,69.4,65.9,1662647,1580457,82190,4.9,IA
96,2013,Jan,69.3,65.9,1662643,1580382,82261,4.9,IA
97,2013,Feb,69.3,65.9,1662690,1580469,82221,4.9,IA
98,2013,Mar,69.3,65.9,1664171,1582269,81902,4.9,IA
99,2013,Apr,69.5,66.1,1668153,1586806,81347,4.9,IA
100,2013,May,69.7,66.3,1673821,1593137,80684,4.8,IA
101,2013,Jun,69.9,66.5,1679506,1599483,80023,4.8,IA
102,2013,Jul,70.0,66.7,1683993,1604608,79385,4.7,IA
103,2013,Aug,70.1,66.8,1686408,1607835,78573,4.7,IA
104,2013,Sep,70.0,66.8,1686554,1609044,77510,4.6,IA
105,2013,Oct,69.9,66.8,1685404,1608832,76572,4.5,IA
106,2013,Nov,69.9,66.7,1684452,1608558,75894,4.5,IA
107,2013,Dec,69.8,66.7,1684792,1609386,75406,4.5,IA
108,2014,Jan,69.9,66.8,1686880,1611910,74970,4.4,IA
109,2014,Feb,70.0,66.9,1690118,1615655,74463,4.4,IA
110,2014,Mar,70.1,67.0,1693311,1619332,73979,4.4,IA
111,2014,Apr,70.2,67.1,1695751,1622168,73583,4.3,IA
112,2014,May,70.2,67.2,1697727,1624533,73194,4.3,IA
113,2014,Jun,70.3,67.2,1699665,1626906,72759,4.3,IA
114,2014,Jul,70.3,67.3,1701256,1628984,72272,4.2,IA
115,2014,Aug,70.3,67.3,1702696,1630943,71753,4.2,IA
116,2014,Sep,70.3,67.4,1704150,1633086,71064,4.2,IA
117,2014,Oct,70.3,67.5,1705341,1635343,69998,4.1,IA
118,2014,Nov,70.3,67.5,1705842,1637265,68577,4.0,IA
119,2014,Dec,70.3,67.5,1705596,1638437,67159,3.9,IA
120,2015,Jan,70.2,67.5,1704798,1638800,65998,3.9,IA
121,2015,Feb,70.2,67.5,1703904,1638715,65189,3.8,IA
122,2015,Mar,70.1,67.5,1703231,1638687,64544,3.8,IA
123,2015,Apr,70.1,67.5,1702323,1638444,63879,3.8,IA
124,2015,May,70.0,67.4,1700817,1637661,63156,3.7,IA
125,2015,Jun,69.9,67.3,1698838,1636400,62438,3.7,IA
126,2015,Jul,69.8,67.2,1697034,1635142,61892,3.6,IA
127,2015,Aug,69.7,67.2,1696005,1634411,61594,3.6,IA
128,2015,Sep,69.7,67.2,1696155,1634605,61550,3.6,IA
129,2015,Oct,69.7,67.2,1697907,1636189,61718,3.6,IA
130,2015,Nov,69.8,67.3,1701237,1639252,61985,3.6,IA
131,2015,Dec,70.0,67.4,1705328,1643195,62133,3.6,IA
132,2016,Jan,70.1,67.6,1708738,1646660,62078,3.6,IA
133,2016,Feb,70.2,67.6,1710383,1648419,61964,3.6,IA
134,2016,Mar,70.1,67.6,1710050,1648133,61917,3.6,IA
135,2016,Apr,70.0,67.5,1708496,1646486,62010,3.6,IA
136,2016,May,69.9,67.4,1706702,1644496,62206,3.6,IA
137,2016,Jun,69.8,67.3,1705132,1642812,62320,3.7,IA
138,2016,Jul,69.7,67.2,1703877,1641745,62132,3.6,IA
139,2016,Aug,69.7,67.1,1702459,1640827,61632,3.6,IA
140,2016,Sep,69.5,67.1,1700400,1639444,60956,3.6,IA
141,2016,Oct,69.4,66.9,1697326,1637247,60079,3.5,IA
142,2016,Nov,69.2,66.8,1693569,1634566,59003,3.5,IA
143,2016,Dec,69.0,66.7,1689919,1632092,57827,3.4,IA
144,2017,Jan,69.0,66.7,1696536,1640207,56329,3.3,IA
145,2017,Feb,68.9,66.7,1695743,1640706,55037,3.2,IA
146,2017,Mar,68.9,66.7,1696350,1642428,53922,3.2,IA
147,2017,Apr,68.9,66.8,1697896,1644766,53130,3.1,IA
148,2017,May,69.0,66.9,1699561,1646955,52606,3.1,IA
149,2017,Jun,69.0,66.9,1700553,1648287,52266,3.1,IA
150,2017,Jul,69.0,66.9,1700544,1648568,51976,3.1,IA
151,2017,Aug,68.9,66.8,1699477,1648009,51468,3.0,IA
152,2017,Sep,68.8,66.7,1697774,1647100,50674,3.0,IA
153,2017,Oct,68.7,66.7,1696152,1646476,49676,2.9,IA
154,2017,Nov,68.6,66.7,1695053,1646441,48612,2.9,IA
155,2017,Dec,68.6,66.7,1695075,1647607,47468,2.8,IA
156,2018,Jan,68.7,66.8,1696976,1650712,46264,2.7,IA
157,2018,Feb,68.8,67.0,1701026,1655931,45095,2.7,IA
158,2018,Mar,69.1,67.3,1706429,1662427,44002,2.6,IA
159,2018,Apr,69.2,67.5,1711544,1668519,43025,2.5,IA
160,2018,May,69.4,67.7,1715246,1672897,42349,2.5,IA
161,2018,Jun,69.4,67.7,1717407,1675364,42043,2.4,IA
162,2018,Jul,69.4,67.7,1718261,1676213,42048,2.4,IA
163,2018,Aug,69.4,67.7,1718668,1676289,42379,2.5,IA
164,2018,Sep,69.4,67.7,1719372,1676525,42847,2.5,IA
165,2018,Oct,69.4,67.7,1720922,1677594,43328,2.5,IA
166,2018,Nov,69.5,67.7,1723734,1680011,43723,2.5,IA
167,2018,Dec,69.6,67.9,1727762,1683836,43926,2.5,IA
168,2019,Jan,69.8,68.0,1732197,1688310,43887,2.5,IA
169,2019,Feb,70.0,68.2,1736453,1692818,43635,2.5,IA
170,2019,Mar,70.1,68.3,1740581,1697118,43463,2.5,IA
171,2019,Apr,70.2,68.5,1744736,1701156,43580,2.5,IA
172,2019,May,70.4,68.6,1748680,1704571,44109,2.5,IA
173,2019,Jun,70.5,68.7,1752230,1707129,45101,2.6,IA
174,2019,Jul,70.5,68.7,1755135,1708734,46401,2.6,IA
175,2019,Aug,70.6,68.7,1757098,1709540,47558,2.7,IA
176,2019,Sep,70.6,68.7,1758313,1710291,48022,2.7,IA
177,2019,Oct,70.6,68.7,1758580,1710838,47742,2.7,IA
178,2019,Nov,70.5,68.6,1757277,1710325,46952,2.7,IA
179,2019,Dec,70.3,68.5,1753532,1707436,46096,2.6,IA
180,2020,Jan,70.0,68.2,1747415,1701909,45506,2.6,IA
181,2020,Feb,69.7,67.9,1739520,1694404,45116,2.6,IA
182,2020,Mar,69.4,67.6,1731056,1686641,44415,2.6,IA
183,2020,Apr,69.0,61.7,1721183,1540749,180434,10.5,IA
184,2020,May,67.1,61.8,1675014,1541346,133668,8.0,IA
185,2020,Jun,66.2,61.9,1651007,1544167,106840,6.5,IA
186,2020,Jul,66.1,62.2,1648875,1553002,95873,5.8,IA
187,2020,Aug,65.9,62.6,1646359,1561925,84434,5.1,IA
188,2020,Sep,66.1,62.9,1651241,1571345,79896,4.8,IA
189,2020,Oct,66.1,63.1,1652825,1577987,74838,4.5,IA
190,2020,Nov,66.3,63.3,1658195,1583691,74504,4.5,IA
191,2020,Dec,66.5,63.5,1661964,1587317,74647,4.5,IA
192,2021,Jan,66.5,63.6,1663589,1590464,73125,4.4,IA
193,2021,Feb,66.6,63.7,1666487,1593411,73076,4.4,IA
194,2021,Mar,66.8,63.9,1671505,1597659,73846,4.4,IA
195,2021,Apr,67.0,64.0,1676502,1601704,74798,4.5,IA
196,2021,May,67.1,64.1,1679868,1604918,74950,4.5,IA
197,2021,Jun,67.2,64.2,1682834,1607573,75261,4.5,IA
198,2021,Jul,67.1,64.2,1682722,1608627,74095,4.4,IA
199,2021,Aug,67.0,64.2,1681377,1609512,71865,4.3,IA
200,2021,Sep,66.9,64.1,1678099,1609344,68755,4.1,IA
201,2021,Oct,66.8,64.1,1677109,1610792,66317,4.0,IA
202,2021,Nov,66.7,64.1,1675768,1610657,65111,3.9,IA
203,2021,Dec,66.7,64.1,1675625,1610773,64852,3.9,IA
204,2022,Jan,66.8,64.3,1680392,1617657,62735,3.7,IA
205,2022,Feb,67.0,64.7,1686648,1627149,59499,3.5,IA
206,2022,Mar,67.2,65.0,1692417,1636828,55589,3.3,IA
207,2022,Apr,67.4,65.4,1697705,1646830,50875,3.0,IA
208,2022,May,67.6,65.8,1704079,1657288,46791,2.7,IA
209,2022,Jun,67.8,66.1,1709232,1665355,43877,2.6,IA
210,2022,Jul,67.8,66.1,1710486,1667145,43341,2.5,IA
211,2022,Aug,67.7,66.0,1709545,1664847,44698,2.6,IA
212,2022,Sep,67.7,65.8,1709769,1663281,46488,2.7,IA
213,2022,Oct,67.7,65.8,1712111,1662431,49680,2.9,IA
214,2022,Nov,67.7,65.6,1711384,1658988,52396,3.1,IA
0,2005,Jan,73.6,70.4,2878253,2755477,122776,4.3,MN
1,2005,Feb,73.5,70.4,2876919,2754981,121938,4.2,MN
2,2005,Mar,73.5,70.4,2877593,2756754,120839,4.2,MN
3,2005,Apr,73.5,70.4,2879816,2760555,119261,4.1,MN
4,2005,May,73.5,70.5,2882721,2765257,117464,4.1,MN
5,2005,Jun,73.5,70.5,2884875,2768925,115950,4.0,MN
6,2005,Jul,73.4,70.5,2885243,2769965,115278,4.0,MN
7,2005,Aug,73.3,70.4,2884095,2768586,115509,4.0,MN
8,2005,Sep,73.2,70.3,2882897,2766312,116585,4.0,MN
9,2005,Oct,73.1,70.1,2882961,2764955,118006,4.1,MN
10,2005,Nov,73.1,70.1,2884450,2765204,119246,4.1,MN
11,2005,Dec,73.1,70.0,2885850,2766158,119692,4.1,MN
12,2006,Jan,73.0,70.0,2886377,2767467,118910,4.1,MN
13,2006,Feb,72.9,70.0,2886107,2768846,117261,4.1,MN
14,2006,Mar,72.9,70.0,2885094,2769722,115372,4.0,MN
15,2006,Apr,72.8,69.9,2883712,2769949,113763,3.9,MN
16,2006,May,72.7,69.8,2882539,2769759,112780,3.9,MN
17,2006,Jun,72.6,69.8,2882243,2769472,112771,3.9,MN
18,2006,Jul,72.6,69.7,2883675,2769850,113825,3.9,MN
19,2006,Aug,72.6,69.7,2887166,2771111,116055,4.0,MN
20,2006,Sep,72.7,69.7,2892049,2772961,119088,4.1,MN
21,2006,Oct,72.7,69.7,2897203,2775300,121903,4.2,MN
22,2006,Nov,72.8,69.6,2901587,2777537,124050,4.3,MN
23,2006,Dec,72.8,69.6,2904402,2778889,125513,4.3,MN
24,2007,Jan,72.7,69.6,2905237,2778670,126567,4.4,MN
25,2007,Feb,72.6,69.5,2904324,2776911,127413,4.4,MN
26,2007,Mar,72.5,69.3,2902138,2774014,128124,4.4,MN
27,2007,Apr,72.4,69.2,2899693,2770677,129016,4.4,MN
28,2007,May,72.3,69.1,2897960,2767511,130449,4.5,MN
29,2007,Jun,72.2,68.9,2897126,2764914,132212,4.6,MN
30,2007,Jul,72.2,68.8,2896892,2762772,134120,4.6,MN
31,2007,Aug,72.1,68.7,2896949,2760940,136009,4.7,MN
32,2007,Sep,72.0,68.6,2897029,2759599,137430,4.7,MN
33,2007,Oct,72.0,68.5,2897040,2758855,138185,4.8,MN
34,2007,Nov,71.9,68.5,2896893,2758896,137997,4.8,MN
35,2007,Dec,71.9,68.5,2896769,2759616,137153,4.7,MN
36,2008,Jan,71.8,68.4,2896805,2760194,136611,4.7,MN
37,2008,Feb,71.8,68.4,2897217,2760058,137159,4.7,MN
38,2008,Mar,71.8,68.3,2898610,2759179,139431,4.8,MN
39,2008,Apr,71.8,68.2,2901263,2757878,143385,4.9,MN
40,2008,May,71.8,68.2,2905299,2756987,148312,5.1,MN
41,2008,Jun,71.9,68.1,2910820,2757296,153524,5.3,MN
42,2008,Jul,72.0,68.1,2916961,2758679,158282,5.4,MN
43,2008,Aug,72.1,68.1,2922523,2760026,162497,5.6,MN
44,2008,Sep,72.1,68.0,2926961,2759427,167534,5.7,MN
45,2008,Oct,72.1,67.8,2930202,2755312,174890,6.0,MN
46,2008,Nov,72.2,67.6,2932497,2747372,185125,6.3,MN
47,2008,Dec,72.2,67.3,2934202,2736774,197428,6.7,MN
48,2009,Jan,72.1,67.0,2935506,2725000,210506,7.2,MN
49,2009,Feb,72.1,66.7,2936857,2714157,222700,7.6,MN
50,2009,Mar,72.1,66.4,2938667,2706532,232135,7.9,MN
51,2009,Apr,72.1,66.3,2940298,2702508,237790,8.1,MN
52,2009,May,72.1,66.2,2940428,2700525,239903,8.2,MN
53,2009,Jun,72.0,66.1,2938602,2699072,239530,8.2,MN
54,2009,Jul,71.9,66.0,2935063,2697239,237824,8.1,MN
55,2009,Aug,71.7,65.9,2930548,2694937,235611,8.0,MN
56,2009,Sep,71.5,65.8,2926112,2692908,233204,8.0,MN
57,2009,Oct,71.4,65.8,2922698,2691628,231070,7.9,MN
58,2009,Nov,71.3,65.7,2921699,2692020,229679,7.9,MN
59,2009,Dec,71.3,65.8,2923951,2694944,229007,7.8,MN
60,2010,Jan,71.4,65.9,2928681,2700412,228269,7.8,MN
61,2010,Feb,71.5,66.0,2933933,2707327,226606,7.7,MN
62,2010,Mar,71.6,66.1,2938371,2714349,224022,7.6,MN
63,2010,Apr,71.6,66.2,2941579,2720784,220795,7.5,MN
64,2010,May,71.6,66.3,2943440,2726065,217375,7.4,MN
65,2010,Jun,71.6,66.3,2943802,2729228,214574,7.3,MN
66,2010,Jul,71.5,66.3,2943204,2729891,213313,7.2,MN
67,2010,Aug,71.4,66.2,2942522,2728897,213625,7.3,MN
68,2010,Sep,71.4,66.2,2942201,2727753,214448,7.3,MN
69,2010,Oct,71.3,66.1,2942469,2728215,214254,7.3,MN
70,2010,Nov,71.3,66.1,2942990,2730889,212101,7.2,MN
71,2010,Dec,71.2,66.2,2943772,2735520,208252,7.1,MN
72,2011,Jan,71.2,66.3,2945255,2741797,203458,6.9,MN
73,2011,Feb,71.2,66.4,2947224,2747825,199399,6.8,MN
74,2011,Mar,71.2,66.5,2948872,2751699,197173,6.7,MN
75,2011,Apr,71.2,66.5,2950303,2753517,196786,6.7,MN
76,2011,May,71.2,66.4,2952020,2754433,197587,6.7,MN
77,2011,Jun,71.2,66.4,2953753,2755639,198114,6.7,MN
78,2011,Jul,71.2,66.4,2955400,2758359,197041,6.7,MN
79,2011,Aug,71.2,66.5,2956624,2762729,193895,6.6,MN
80,2011,Sep,71.1,66.6,2956803,2767696,189107,6.4,MN
81,2011,Oct,71.0,66.6,2955882,2772119,183763,6.2,MN
82,2011,Nov,70.9,66.7,2953876,2775177,178699,6.0,MN
83,2011,Dec,70.8,66.6,2950830,2776403,174427,5.9,MN
84,2012,Jan,70.7,66.6,2947490,2776132,171358,5.8,MN
85,2012,Feb,70.6,66.5,2944994,2775710,169284,5.7,MN
86,2012,Mar,70.5,66.5,2943537,2775538,167999,5.7,MN
87,2012,Apr,70.5,66.4,2942677,2775106,167571,5.7,MN
88,2012,May,70.4,66.4,2942728,2775088,167640,5.7,MN
89,2012,Jun,70.4,66.4,2944302,2776517,167785,5.7,MN
90,2012,Jul,70.4,66.4,2947024,2779521,167503,5.7,MN
91,2012,Aug,70.4,66.5,2950631,2783832,166799,5.7,MN
92,2012,Sep,70.5,66.5,2955118,2789269,165849,5.6,MN
93,2012,Oct,70.5,66.6,2959485,2795149,164336,5.6,MN
94,2012,Nov,70.6,66.7,2962759,2800283,162476,5.5,MN
95,2012,Dec,70.6,66.7,2964526,2803934,160592,5.4,MN
96,2013,Jan,70.5,66.8,2964871,2806119,158752,5.4,MN
97,2013,Feb,70.5,66.7,2964112,2807168,156944,5.3,MN
98,2013,Mar,70.4,66.7,2962646,2807616,155030,5.2,MN
99,2013,Apr,70.3,66.7,2961290,2808242,153048,5.2,MN
100,2013,May,70.3,66.7,2960131,2808881,151250,5.1,MN
101,2013,Jun,70.2,66.6,2959310,2809549,149761,5.1,MN
102,2013,Jul,70.1,66.6,2959245,2810761,148484,5.0,MN
103,2013,Aug,70.1,66.6,2959719,2812839,146880,5.0,MN
104,2013,Sep,70.0,66.6,2960319,2815492,144827,4.9,MN
105,2013,Oct,70.0,66.6,2961292,2818328,142964,4.8,MN
106,2013,Nov,70.0,66.7,2962764,2821182,141582,4.8,MN
107,2013,Dec,70.0,66.7,2964246,2823768,140478,4.7,MN
108,2014,Jan,70.0,66.7,2965437,2826045,139392,4.7,MN
109,2014,Feb,70.0,66.7,2966801,2828846,137955,4.6,MN
110,2014,Mar,70.0,66.8,2969112,2833095,136017,4.6,MN
111,2014,Apr,70.0,66.9,2971996,2838498,133498,4.5,MN
112,2014,May,70.0,67.0,2975113,2844737,130376,4.4,MN
113,2014,Jun,70.1,67.1,2978678,2851608,127070,4.3,MN
114,2014,Jul,70.1,67.2,2982337,2858156,124181,4.2,MN
115,2014,Aug,70.1,67.3,2985812,2863719,122093,4.1,MN
116,2014,Sep,70.2,67.3,2988734,2868043,120691,4.0,MN
117,2014,Oct,70.2,67.4,2990545,2871022,119523,4.0,MN
118,2014,Nov,70.1,67.4,2991030,2872957,118073,3.9,MN
119,2014,Dec,70.1,67.4,2991295,2874858,116437,3.9,MN
120,2015,Jan,70.1,67.4,2992386,2877365,115021,3.8,MN
121,2015,Feb,70.1,67.4,2994638,2880470,114168,3.8,MN
122,2015,Mar,70.2,67.5,2998186,2884337,113849,3.8,MN
123,2015,Apr,70.2,67.6,3002331,2888543,113788,3.8,MN
124,2015,May,70.3,67.6,3005863,2892071,113792,3.8,MN
125,2015,Jun,70.3,67.6,3007688,2894004,113684,3.8,MN
126,2015,Jul,70.2,67.6,3008042,2894625,113417,3.8,MN
127,2015,Aug,70.2,67.5,3007887,2894759,113128,3.8,MN
128,2015,Sep,70.1,67.5,3008335,2895504,112831,3.8,MN
129,2015,Oct,70.1,67.5,3010487,2897657,112830,3.7,MN
130,2015,Nov,70.2,67.5,3014550,2901181,113369,3.8,MN
131,2015,Dec,70.2,67.6,3019343,2905253,114090,3.8,MN
132,2016,Jan,70.3,67.6,3022956,2908419,114537,3.8,MN
133,2016,Feb,70.3,67.6,3024171,2909497,114674,3.8,MN
134,2016,Mar,70.2,67.5,3023055,2908446,114609,3.8,MN
135,2016,Apr,70.1,67.4,3021085,2906473,114612,3.8,MN
136,2016,May,70.0,67.4,3019912,2904922,114990,3.8,MN
137,2016,Jun,70.0,67.3,3019989,2904199,115790,3.8,MN
138,2016,Jul,69.9,67.2,3021008,2904097,116911,3.9,MN
139,2016,Aug,69.9,67.2,3022594,2904394,118200,3.9,MN
140,2016,Sep,69.9,67.1,3024432,2904939,119493,4.0,MN
141,2016,Oct,69.9,67.1,3026209,2906061,120148,4.0,MN
142,2016,Nov,69.9,67.1,3028316,2908696,119620,4.0,MN
143,2016,Dec,69.9,67.2,3031048,2913051,117997,3.9,MN
144,2017,Jan,70.0,67.3,3052870,2935369,117501,3.8,MN
145,2017,Feb,70.1,67.5,3058235,2943856,114379,3.7,MN
146,2017,Mar,70.1,67.6,3063521,2952217,111304,3.6,MN
147,2017,Apr,70.2,67.7,3068233,2959327,108906,3.5,MN
148,2017,May,70.2,67.8,3072030,2964839,107191,3.5,MN
149,2017,Jun,70.2,67.8,3074738,2968624,106114,3.5,MN
150,2017,Jul,70.2,67.8,3076593,2970957,105636,3.4,MN
151,2017,Aug,70.2,67.8,3077320,2972123,105197,3.4,MN
152,2017,Sep,70.1,67.7,3077085,2972553,104532,3.4,MN
153,2017,Oct,70.0,67.7,3076436,2972950,103486,3.4,MN
154,2017,Nov,70.0,67.6,3075555,2973295,102260,3.3,MN
155,2017,Dec,69.9,67.6,3075176,2974306,100870,3.3,MN
156,2018,Jan,69.9,67.6,3076015,2976627,99388,3.2,MN
157,2018,Feb,69.9,67.7,3078239,2980428,97811,3.2,MN
158,2018,Mar,69.9,67.7,3081147,2985096,96051,3.1,MN
159,2018,Apr,69.9,67.8,3083193,2989013,94180,3.1,MN
160,2018,May,69.9,67.8,3083692,2990930,92762,3.0,MN
161,2018,Jun,69.8,67.7,3083120,2991009,92111,3.0,MN
162,2018,Jul,69.7,67.7,3082249,2990007,92242,3.0,MN
163,2018,Aug,69.7,67.6,3082818,2989156,93662,3.0,MN
164,2018,Sep,69.7,67.5,3085660,2989117,96543,3.1,MN
165,2018,Oct,69.8,67.5,3090390,2990127,100263,3.2,MN
166,2018,Nov,69.8,67.5,3096051,2992215,103836,3.4,MN
167,2018,Dec,69.9,67.5,3101375,2995140,106235,3.4,MN
168,2019,Jan,70.0,67.6,3105550,2998536,107014,3.4,MN
169,2019,Feb,70.0,67.6,3108585,3002430,106155,3.4,MN
170,2019,Mar,70.0,67.7,3111323,3006840,104483,3.4,MN
171,2019,Apr,70.1,67.8,3114952,3012067,102885,3.3,MN
172,2019,May,70.1,67.8,3119897,3017819,102078,3.3,MN
173,2019,Jun,70.2,67.9,3125700,3023018,102682,3.3,MN
174,2019,Jul,70.3,67.9,3131553,3026657,104896,3.3,MN
175,2019,Aug,70.4,67.9,3136938,3028991,107947,3.4,MN
176,2019,Sep,70.4,68.0,3142213,3031864,110349,3.5,MN
177,2019,Oct,70.5,68.0,3148281,3036097,112184,3.6,MN
178,2019,Nov,70.6,68.1,3155363,3041440,113923,3.6,MN
179,2019,Dec,70.7,68.1,3161553,3045532,116021,3.7,MN
180,2020,Jan,70.8,68.1,3164931,3046002,118929,3.8,MN
181,2020,Feb,70.8,68.0,3164775,3041816,122959,3.9,MN
182,2020,Mar,70.7,67.8,3161670,3034563,127107,4.0,MN
183,2020,Apr,67.8,61.7,3033422,2761005,272417,9.0,MN
184,2020,May,69.1,61.6,3094261,2758762,335499,10.8,MN
185,2020,Jun,71.3,65.1,3192385,2915390,276995,8.7,MN
186,2020,Jul,70.8,65.2,3170933,2921354,249579,7.9,MN
187,2020,Aug,70.1,65.3,3143270,2926870,216400,6.9,MN
188,2020,Sep,69.7,65.4,3124017,2929523,194494,6.2,MN
189,2020,Oct,69.0,65.2,3094425,2925515,168910,5.5,MN
190,2020,Nov,68.5,65.0,3070597,2917073,153524,5.0,MN
191,2020,Dec,67.9,64.8,3047413,2906607,140806,4.6,MN
192,2021,Jan,67.4,64.6,3025190,2898627,126563,4.2,MN
193,2021,Feb,67.1,64.5,3012179,2894987,117192,3.9,MN
194,2021,Mar,67.0,64.6,3007868,2897179,110689,3.7,MN
195,2021,Apr,67.1,64.7,3009626,2903107,106519,3.5,MN
196,2021,May,67.1,64.8,3012884,2910210,102674,3.4,MN
197,2021,Jun,67.2,64.9,3017178,2915674,101504,3.4,MN
198,2021,Jul,67.2,65.0,3019776,2919586,100190,3.3,MN
199,2021,Aug,67.3,65.1,3023110,2924210,98900,3.3,MN
200,2021,Sep,67.3,65.1,3025818,2929240,96578,3.2,MN
201,2021,Oct,67.3,65.2,3030169,2935496,94673,3.1,MN
202,2021,Nov,67.3,65.2,3029884,2937292,92592,3.1,MN
203,2021,Dec,67.3,65.2,3028904,2937398,91506,3.0,MN
204,2022,Jan,67.6,65.6,3045355,2956547,88808,2.9,MN
205,2022,Feb,67.9,66.1,3059493,2976554,82939,2.7,MN
206,2022,Mar,68.1,66.5,3071742,2996007,75735,2.5,MN
207,2022,Apr,68.3,66.8,3080002,3012362,67640,2.2,MN
208,2022,May,68.4,67.1,3086812,3025250,61562,2.0,MN
209,2022,Jun,68.5,67.3,3092148,3034980,57168,1.8,MN
210,2022,Jul,68.4,67.2,3088059,3032557,55502,1.8,MN
211,2022,Aug,68.2,66.9,3082333,3024075,58258,1.9,MN
212,2022,Sep,68.1,66.7,3077830,3016155,61675,2.0,MN
213,2022,Oct,68.0,66.5,3073064,3007193,65871,2.1,MN
214,2022,Nov,67.9,66.3,3071168,2999260,71908,2.3,MN
0,2005,Jan,70.8,67.0,1458973,1380627,78346,5.4,KS
1,2005,Feb,70.8,67.0,1458867,1380967,77900,5.3,KS
2,2005,Mar,70.7,67.0,1458695,1381581,77114,5.3,KS
3,2005,Apr,70.7,67.0,1458396,1382409,75987,5.2,KS
4,2005,May,70.6,67.0,1458126,1383469,74657,5.1,KS
5,2005,Jun,70.6,67.0,1458034,1384566,73468,5.0,KS
6,2005,Jul,70.5,67.0,1458268,1385522,72746,5.0,KS
7,2005,Aug,70.5,67.0,1458670,1386265,72405,5.0,KS
8,2005,Sep,70.5,67.0,1458875,1386742,72133,4.9,KS
9,2005,Oct,70.4,66.9,1458597,1386985,71612,4.9,KS
10,2005,Nov,70.3,66.9,1457882,1387093,70789,4.9,KS
11,2005,Dec,70.2,66.9,1456928,1387302,69626,4.8,KS
12,2006,Jan,70.2,66.9,1455936,1387766,68170,4.7,KS
13,2006,Feb,70.1,66.9,1455091,1388411,66680,4.6,KS
14,2006,Mar,70.1,66.9,1454601,1389076,65525,4.5,KS
15,2006,Apr,70.2,67.0,1457490,1392614,64876,4.5,KS
16,2006,May,70.3,67.2,1460742,1396157,64585,4.4,KS
17,2006,Jun,70.4,67.3,1464180,1399759,64421,4.4,KS
18,2006,Jul,70.6,67.5,1467807,1403581,64226,4.4,KS
19,2006,Aug,70.7,67.6,1471727,1407676,64051,4.4,KS
20,2006,Sep,70.9,67.8,1475958,1411988,63970,4.3,KS
21,2006,Oct,71.0,67.9,1478938,1415081,63857,4.3,KS
22,2006,Nov,71.2,68.1,1484594,1420985,63609,4.3,KS
23,2006,Dec,71.2,68.1,1485269,1421997,63272,4.3,KS
24,2007,Jan,71.1,68.1,1485282,1422275,63007,4.2,KS
25,2007,Feb,71.0,68.0,1484899,1422087,62812,4.2,KS
26,2007,Mar,71.0,68.0,1484163,1421613,62550,4.2,KS
27,2007,Apr,70.9,67.9,1483334,1421088,62246,4.2,KS
28,2007,May,70.8,67.8,1482871,1420764,62107,4.2,KS
29,2007,Jun,70.8,67.8,1482976,1420851,62125,4.2,KS
30,2007,Jul,70.7,67.8,1483761,1421335,62426,4.2,KS
31,2007,Aug,70.8,67.8,1485166,1422076,63090,4.2,KS
32,2007,Sep,70.8,67.8,1486755,1422954,63801,4.3,KS
33,2007,Oct,70.8,67.7,1487983,1423641,64342,4.3,KS
34,2007,Nov,70.8,67.7,1488571,1424075,64496,4.3,KS
35,2007,Dec,70.8,67.7,1488603,1424446,64157,4.3,KS
36,2008,Jan,70.7,67.7,1488330,1424783,63547,4.3,KS
37,2008,Feb,70.7,67.7,1488077,1425145,62932,4.2,KS
38,2008,Mar,70.7,67.7,1488306,1425587,62719,4.2,KS
39,2008,Apr,70.7,67.7,1489101,1425930,63171,4.2,KS
40,2008,May,70.7,67.6,1490277,1425962,64315,4.3,KS
41,2008,Jun,70.7,67.6,1491760,1425746,66014,4.4,KS
42,2008,Jul,70.7,67.5,1493312,1425477,67835,4.5,KS
43,2008,Aug,70.8,67.5,1494865,1425260,69605,4.7,KS
44,2008,Sep,70.8,67.4,1496707,1424974,71733,4.8,KS
45,2008,Oct,70.8,67.3,1498893,1424409,74484,5.0,KS
46,2008,Nov,70.9,67.2,1501360,1423372,77988,5.2,KS
47,2008,Dec,71.0,67.1,1504198,1421825,82373,5.5,KS
48,2009,Jan,71.1,67.0,1507169,1419811,87358,5.8,KS
49,2009,Feb,71.2,66.8,1510355,1417552,92803,6.1,KS
50,2009,Mar,71.3,66.7,1513752,1415542,98210,6.5,KS
51,2009,Apr,71.4,66.6,1517037,1414106,102931,6.8,KS
52,2009,May,71.5,66.5,1519576,1412960,106616,7.0,KS
53,2009,Jun,71.5,66.4,1520649,1411631,109018,7.2,KS
54,2009,Jul,71.4,66.2,1519761,1409610,110151,7.2,KS
55,2009,Aug,71.2,66.0,1516989,1406736,110253,7.3,KS
56,2009,Sep,70.9,65.8,1513022,1403365,109657,7.2,KS
57,2009,Oct,70.7,65.6,1508787,1399911,108876,7.2,KS
58,2009,Nov,70.5,65.4,1505314,1396912,108402,7.2,KS
59,2009,Dec,70.3,65.3,1503151,1394859,108292,7.2,KS
60,2010,Jan,70.3,65.2,1502302,1394052,108250,7.2,KS
61,2010,Feb,70.2,65.2,1502043,1394188,107855,7.2,KS
62,2010,Mar,70.1,65.2,1501694,1394805,106889,7.1,KS
63,2010,Apr,69.9,65.0,1501224,1395682,105542,7.0,KS
64,2010,May,69.8,65.0,1500581,1396641,103940,6.9,KS
65,2010,Jun,69.8,65.0,1499954,1397316,102638,6.8,KS
66,2010,Jul,69.7,65.0,1499521,1397499,102022,6.8,KS
67,2010,Aug,69.7,64.9,1499329,1397291,102038,6.8,KS
68,2010,Sep,69.6,64.9,1499286,1396809,102477,6.8,KS
69,2010,Oct,69.6,64.8,1499560,1396563,102997,6.9,KS
70,2010,Nov,69.6,64.8,1499951,1396803,103148,6.9,KS
71,2010,Dec,69.6,64.8,1500190,1397503,102687,6.8,KS
72,2011,Jan,69.6,64.8,1500267,1398503,101764,6.8,KS
73,2011,Feb,69.5,64.9,1499954,1399506,100448,6.7,KS
74,2011,Mar,69.5,64.9,1499072,1400245,98827,6.6,KS
75,2011,Apr,69.4,64.9,1497707,1400475,97232,6.5,KS
76,2011,May,69.3,64.8,1496444,1400405,96039,6.4,KS
77,2011,Jun,69.2,64.8,1495824,1400534,95290,6.4,KS
78,2011,Jul,69.2,64.8,1496109,1401222,94887,6.3,KS
79,2011,Aug,69.2,64.8,1497076,1402453,94623,6.3,KS
80,2011,Sep,69.2,64.9,1498090,1403990,94100,6.3,KS
81,2011,Oct,69.2,64.9,1498563,1405412,93151,6.2,KS
82,2011,Nov,69.1,64.9,1498063,1406203,91860,6.1,KS
83,2011,Dec,69.0,64.9,1496515,1406144,90371,6.0,KS
84,2012,Jan,68.9,64.8,1494362,1405492,88870,5.9,KS
85,2012,Feb,68.8,64.7,1492333,1404669,87664,5.9,KS
86,2012,Mar,68.7,64.7,1490738,1403751,86987,5.8,KS
87,2012,Apr,68.6,64.6,1489485,1402934,86551,5.8,KS
88,2012,May,68.5,64.6,1488736,1402661,86075,5.8,KS
89,2012,Jun,68.5,64.5,1488524,1403130,85394,5.7,KS
90,2012,Jul,68.4,64.6,1488847,1404335,84512,5.7,KS
91,2012,Aug,68.5,64.6,1489743,1405991,83752,5.6,KS
92,2012,Sep,68.5,64.7,1491050,1407653,83397,5.6,KS
93,2012,Oct,68.5,64.7,1492122,1408760,83362,5.6,KS
94,2012,Nov,68.5,64.7,1492672,1409248,83424,5.6,KS
95,2012,Dec,68.5,64.7,1492648,1409265,83383,5.6,KS
96,2013,Jan,68.4,64.6,1492010,1408859,83151,5.6,KS
97,2013,Feb,68.4,64.6,1491109,1408465,82644,5.5,KS
98,2013,Mar,68.4,64.6,1490526,1408599,81927,5.5,KS
99,2013,Apr,68.3,64.6,1490653,1409461,81192,5.4,KS
100,2013,May,68.3,64.6,1491094,1410482,80612,5.4,KS
101,2013,Jun,68.3,64.7,1491270,1411118,80152,5.4,KS
102,2013,Jul,68.3,64.6,1490847,1411224,79623,5.3,KS
103,2013,Aug,68.2,64.6,1489665,1411057,78608,5.3,KS
104,2013,Sep,68.1,64.6,1488146,1411091,77055,5.2,KS
105,2013,Oct,68.0,64.6,1487170,1411799,75371,5.1,KS
106,2013,Nov,68.0,64.6,1487212,1413405,73807,5.0,KS
107,2013,Dec,68.0,64.7,1488263,1415787,72476,4.9,KS
108,2014,Jan,68.1,64.8,1490102,1418761,71341,4.8,KS
109,2014,Feb,68.1,64.9,1492219,1421820,70399,4.7,KS
110,2014,Mar,68.2,65.0,1494043,1424398,69645,4.7,KS
111,2014,Apr,68.2,65.1,1495057,1426026,69031,4.6,KS
112,2014,May,68.2,65.1,1495273,1426868,68405,4.6,KS
113,2014,Jun,68.2,65.1,1495152,1427461,67691,4.5,KS
114,2014,Jul,68.1,65.1,1494899,1427996,66903,4.5,KS
115,2014,Aug,68.1,65.1,1494750,1428614,66136,4.4,KS
116,2014,Sep,68.0,65.1,1494751,1429313,65438,4.4,KS
117,2014,Oct,68.0,65.0,1494702,1429984,64718,4.3,KS
118,2014,Nov,68.0,65.0,1494484,1430308,64176,4.3,KS
119,2014,Dec,67.9,65.0,1494280,1430176,64104,4.3,KS
120,2015,Jan,67.9,65.0,1494068,1429606,64462,4.3,KS
121,2015,Feb,67.9,64.9,1493764,1428745,65019,4.4,KS
122,2015,Mar,67.8,64.9,1493443,1428091,65352,4.4,KS
123,2015,Apr,67.8,64.9,1493226,1428104,65122,4.4,KS
124,2015,May,67.8,64.9,1493024,1428789,64235,4.3,KS
125,2015,Jun,67.7,64.9,1492703,1429837,62866,4.2,KS
126,2015,Jul,67.7,64.9,1492465,1431085,61380,4.1,KS
127,2015,Aug,67.7,64.9,1492607,1432469,60138,4.0,KS
128,2015,Sep,67.7,65.0,1493272,1433984,59288,4.0,KS
129,2015,Oct,67.7,65.0,1494509,1435575,58934,3.9,KS
130,2015,Nov,67.7,65.1,1496037,1437062,58975,3.9,KS
131,2015,Dec,67.8,65.1,1497255,1438196,59059,3.9,KS
132,2016,Jan,67.8,65.1,1497864,1438842,59022,3.9,KS
133,2016,Feb,67.7,65.1,1497789,1438855,58934,3.9,KS
134,2016,Mar,67.7,65.0,1496952,1438043,58909,3.9,KS
135,2016,Apr,67.6,64.9,1495476,1436383,59093,4.0,KS
136,2016,May,67.5,64.8,1493780,1434209,59571,4.0,KS
137,2016,Jun,67.4,64.7,1492201,1431926,60275,4.0,KS
138,2016,Jul,67.3,64.6,1490884,1429885,60999,4.1,KS
139,2016,Aug,67.2,64.5,1489730,1428192,61538,4.1,KS
140,2016,Sep,67.2,64.4,1488560,1426801,61759,4.1,KS
141,2016,Oct,67.1,64.3,1487280,1425871,61409,4.1,KS
142,2016,Nov,67.0,64.3,1486064,1425661,60403,4.1,KS
143,2016,Dec,67.0,64.3,1485099,1426125,58974,4.0,KS
144,2017,Jan,66.9,64.3,1488616,1431211,57405,3.9,KS
145,2017,Feb,66.9,64.3,1488309,1432394,55915,3.8,KS
146,2017,Mar,66.9,64.4,1488542,1433704,54838,3.7,KS
147,2017,Apr,66.9,64.5,1489349,1435017,54332,3.6,KS
148,2017,May,66.9,64.5,1490429,1436226,54203,3.6,KS
149,2017,Jun,67.0,64.5,1491269,1437066,54203,3.6,KS
150,2017,Jul,67.0,64.5,1491424,1437289,54135,3.6,KS
151,2017,Aug,66.9,64.5,1490537,1436741,53796,3.6,KS
152,2017,Sep,66.8,64.4,1488669,1435493,53176,3.6,KS
153,2017,Oct,66.7,64.3,1486252,1433830,52422,3.5,KS
154,2017,Nov,66.5,64.2,1483917,1432248,51669,3.5,KS
155,2017,Dec,66.5,64.2,1482474,1431598,50876,3.4,KS
156,2018,Jan,66.4,64.2,1482526,1432375,50151,3.4,KS
157,2018,Feb,66.5,64.3,1484117,1434529,49588,3.3,KS
158,2018,Mar,66.6,64.4,1486529,1437419,49110,3.3,KS
159,2018,Apr,66.7,64.5,1488704,1440058,48646,3.3,KS
160,2018,May,66.7,64.6,1489930,1441610,48320,3.2,KS
161,2018,Jun,66.7,64.6,1490052,1441918,48134,3.2,KS
162,2018,Jul,66.7,64.5,1489304,1441266,48038,3.2,KS
163,2018,Aug,66.6,64.5,1488425,1440300,48125,3.2,KS
164,2018,Sep,66.6,64.4,1487959,1439589,48370,3.3,KS
165,2018,Oct,66.5,64.4,1488165,1439498,48667,3.3,KS
166,2018,Nov,66.6,64.4,1488909,1440032,48877,3.3,KS
167,2018,Dec,66.6,64.4,1489893,1441041,48852,3.3,KS
168,2019,Jan,66.6,64.5,1490817,1442343,48474,3.3,KS
169,2019,Feb,66.7,64.5,1491604,1443860,47744,3.2,KS
170,2019,Mar,66.7,64.6,1492413,1445446,46967,3.1,KS
171,2019,Apr,66.7,64.6,1493496,1447129,46367,3.1,KS
172,2019,May,66.8,64.7,1494848,1448766,46082,3.1,KS
173,2019,Jun,66.8,64.8,1496517,1450332,46185,3.1,KS
174,2019,Jul,66.9,64.8,1498372,1451784,46588,3.1,KS
175,2019,Aug,66.9,64.8,1500051,1453101,46950,3.1,KS
176,2019,Sep,67.0,64.9,1501585,1454675,46910,3.1,KS
177,2019,Oct,67.0,64.9,1502979,1456372,46607,3.1,KS
178,2019,Nov,67.0,64.9,1504099,1457792,46307,3.1,KS
179,2019,Dec,67.0,64.9,1504255,1457916,46339,3.1,KS
180,2020,Jan,66.9,64.8,1502767,1456191,46576,3.1,KS
181,2020,Feb,66.7,64.7,1499390,1452813,46577,3.1,KS
182,2020,Mar,66.5,64.5,1494910,1449038,45872,3.1,KS
183,2020,Apr,66.1,58.0,1485740,1304278,181462,12.2,KS
184,2020,May,66.3,60.3,1490016,1355766,134250,9.0,KS
185,2020,Jun,65.9,61.2,1481657,1374597,107060,7.2,KS
186,2020,Jul,66.2,61.9,1488164,1392459,95705,6.4,KS
187,2020,Aug,66.3,62.6,1490653,1407078,83575,5.6,KS
188,2020,Sep,66.5,63.1,1496240,1418668,77572,5.2,KS
189,2020,Oct,66.5,63.4,1496277,1426269,70008,4.7,KS
190,2020,Nov,66.5,63.6,1497210,1430979,66231,4.4,KS
191,2020,Dec,66.5,63.7,1496184,1433882,62302,4.2,KS
192,2021,Jan,66.3,63.8,1493252,1436492,56760,3.8,KS
193,2021,Feb,66.3,63.9,1492655,1439203,53452,3.6,KS
194,2021,Mar,66.3,64.0,1493937,1442039,51898,3.5,KS
195,2021,Apr,66.4,64.1,1496076,1444461,51615,3.5,KS
196,2021,May,66.5,64.2,1497684,1446272,51412,3.4,KS
197,2021,Jun,66.5,64.2,1499119,1447334,51785,3.5,KS
198,2021,Jul,66.5,64.2,1499062,1448259,50803,3.4,KS
199,2021,Aug,66.4,64.2,1497808,1449149,48659,3.2,KS
200,2021,Sep,66.3,64.3,1496137,1450655,45482,3.0,KS
201,2021,Oct,66.2,64.3,1495332,1452439,42893,2.9,KS
202,2021,Nov,66.2,64.3,1495022,1453420,41602,2.8,KS
203,2021,Dec,66.1,64.3,1495233,1453912,41321,2.8,KS
204,2022,Jan,66.1,64.4,1495634,1456637,38997,2.6,KS
205,2022,Feb,66.2,64.5,1496305,1459057,37248,2.5,KS
206,2022,Mar,66.2,64.6,1498917,1462811,36106,2.4,KS
207,2022,Apr,66.3,64.8,1501739,1466409,35330,2.4,KS
208,2022,May,66.5,64.9,1505438,1470139,35299,2.3,KS
209,2022,Jun,66.5,64.9,1507053,1471073,35980,2.4,KS
210,2022,Jul,66.4,64.8,1505413,1468604,36809,2.4,KS
211,2022,Aug,66.2,64.5,1501107,1462937,38170,2.5,KS
212,2022,Sep,66.1,64.3,1499426,1459946,39480,2.6,KS
213,2022,Oct,66.0,64.2,1499033,1457717,41316,2.8,KS
214,2022,Nov,66.0,64.1,1499058,1456472,42586,2.8,KS
0,2005,Jan,70.7,67.3,3016579,2872890,143689,4.8,WI
1,2005,Feb,70.6,67.3,3015702,2872864,142838,4.7,WI
2,2005,Mar,70.6,67.3,3016078,2873999,142079,4.7,WI
3,2005,Apr,70.6,67.3,3017984,2876475,141509,4.7,WI
4,2005,May,70.6,67.3,3021665,2880445,141220,4.7,WI
5,2005,Jun,70.7,67.4,3026367,2884933,141434,4.7,WI
6,2005,Jul,70.7,67.4,3031393,2888786,142607,4.7,WI
7,2005,Aug,70.8,67.4,3036040,2891742,144298,4.8,WI
8,2005,Sep,70.8,67.4,3039521,2893934,145587,4.8,WI
9,2005,Oct,70.7,67.4,3041767,2895781,145986,4.8,WI
10,2005,Nov,70.7,67.3,3043147,2897652,145495,4.8,WI
11,2005,Dec,70.7,67.3,3043904,2899804,144100,4.7,WI
12,2006,Jan,70.7,67.4,3044830,2902831,141999,4.7,WI
13,2006,Feb,70.7,67.4,3046724,2906854,139870,4.6,WI
14,2006,Mar,70.7,67.5,3049844,2911405,138439,4.5,WI
15,2006,Apr,70.8,67.6,3054068,2915742,138326,4.5,WI
16,2006,May,70.8,67.6,3059089,2919686,139403,4.6,WI
17,2006,Jun,70.9,67.6,3064326,2923138,141188,4.6,WI
18,2006,Jul,71.0,67.7,3069428,2926323,143105,4.7,WI
19,2006,Aug,71.0,67.7,3074307,2929287,145020,4.7,WI
20,2006,Sep,71.1,67.7,3078965,2932001,146964,4.8,WI
21,2006,Oct,71.1,67.7,3083012,2934814,148198,4.8,WI
22,2006,Nov,71.1,67.7,3085923,2937397,148526,4.8,WI
23,2006,Dec,71.1,67.7,3087289,2939043,148246,4.8,WI
24,2007,Jan,71.1,67.7,3087107,2939387,147720,4.8,WI
25,2007,Feb,71.0,67.6,3086120,2938906,147214,4.8,WI
26,2007,Mar,71.0,67.6,3084887,2938058,146829,4.8,WI
27,2007,Apr,70.9,67.5,3084013,2937255,146758,4.8,WI
28,2007,May,70.8,67.5,3084018,2936652,147366,4.8,WI
29,2007,Jun,70.8,67.4,3084946,2936311,148635,4.8,WI
30,2007,Jul,70.8,67.4,3086615,2936378,150237,4.9,WI
31,2007,Aug,70.8,67.3,3088677,2936986,151691,4.9,WI
32,2007,Sep,70.8,67.3,3090646,2938383,152263,4.9,WI
33,2007,Oct,70.8,67.3,3091929,2940541,151388,4.9,WI
34,2007,Nov,70.7,67.3,3092492,2943825,148667,4.8,WI
35,2007,Dec,70.7,67.4,3092618,2948303,144315,4.7,WI
36,2008,Jan,70.7,67.5,3092444,2952857,139587,4.5,WI
37,2008,Feb,70.6,67.5,3092050,2956324,135726,4.4,WI
38,2008,Mar,70.6,67.5,3091763,2957863,133900,4.3,WI
39,2008,Apr,70.6,67.5,3091788,2957241,134547,4.4,WI
40,2008,May,70.5,67.4,3092342,2955027,137315,4.4,WI
41,2008,Jun,70.5,67.3,3093969,2952277,141692,4.6,WI
42,2008,Jul,70.5,67.2,3096523,2949524,146999,4.7,WI
43,2008,Aug,70.6,67.1,3099708,2946571,153137,4.9,WI
44,2008,Sep,70.6,66.9,3103711,2942506,161205,5.2,WI
45,2008,Oct,70.7,66.7,3108572,2935774,172798,5.6,WI
46,2008,Nov,70.8,66.5,3113762,2924909,188853,6.1,WI
47,2008,Dec,70.8,66.1,3118667,2909875,208792,6.7,WI
48,2009,Jan,70.9,65.7,3122945,2892187,230758,7.4,WI
49,2009,Feb,70.9,65.2,3126622,2874456,252166,8.1,WI
50,2009,Mar,71.0,64.9,3129930,2859606,270324,8.6,WI
51,2009,Apr,71.0,64.6,3132217,2848985,283232,9.0,WI
52,2009,May,71.0,64.4,3131940,2841498,290442,9.3,WI
53,2009,Jun,70.8,64.2,3128053,2835423,292630,9.4,WI
54,2009,Jul,70.6,64.0,3120387,2828900,291487,9.3,WI
55,2009,Aug,70.4,63.8,3110072,2820936,289136,9.3,WI
56,2009,Sep,70.1,63.6,3099185,2812227,286958,9.3,WI
57,2009,Oct,69.8,63.4,3089933,2804121,285812,9.2,WI
58,2009,Nov,69.7,63.2,3084461,2798737,285724,9.3,WI
59,2009,Dec,69.6,63.2,3083749,2797682,286067,9.3,WI
60,2010,Jan,69.7,63.2,3086454,2800945,285509,9.3,WI
61,2010,Feb,69.7,63.3,3089495,2806625,282870,9.2,WI
62,2010,Mar,69.7,63.4,3090610,2812648,277962,9.0,WI
63,2010,Apr,69.8,63.6,3089354,2817875,271479,8.8,WI
64,2010,May,69.7,63.7,3086350,2821846,264504,8.6,WI
65,2010,Jun,69.6,63.7,3082609,2824115,258494,8.4,WI
66,2010,Jul,69.5,63.7,3079417,2824935,254482,8.3,WI
67,2010,Aug,69.4,63.7,3077502,2825260,252242,8.2,WI
68,2010,Sep,69.3,63.7,3076543,2825612,250931,8.2,WI
69,2010,Oct,69.3,63.6,3076209,2826902,249307,8.1,WI
70,2010,Nov,69.2,63.7,3075716,2829157,246559,8.0,WI
71,2010,Dec,69.2,63.7,3074471,2831638,242833,7.9,WI
72,2011,Jan,69.1,63.7,3072930,2834013,238917,7.8,WI
73,2011,Feb,69.0,63.7,3071357,2835627,235730,7.7,WI
74,2011,Mar,69.0,63.7,3069439,2835861,233578,7.6,WI
75,2011,Apr,68.9,63.7,3067488,2834768,232720,7.6,WI
76,2011,May,68.8,63.6,3066514,2833324,233190,7.6,WI
77,2011,Jun,68.8,63.6,3067022,2832807,234215,7.6,WI
78,2011,Jul,68.8,63.6,3069100,2834342,234758,7.6,WI
79,2011,Aug,68.9,63.6,3072085,2838003,234082,7.6,WI
80,2011,Sep,68.9,63.7,3074803,2842921,231882,7.5,WI
81,2011,Oct,68.9,63.8,3076325,2847838,228487,7.4,WI
82,2011,Nov,68.9,63.8,3075869,2851587,224282,7.3,WI
83,2011,Dec,68.8,63.9,3073596,2853852,219744,7.1,WI
84,2012,Jan,68.7,63.9,3070628,2854971,215657,7.0,WI
85,2012,Feb,68.6,63.9,3068522,2855567,212955,6.9,WI
86,2012,Mar,68.6,63.8,3067746,2855416,212330,6.9,WI
87,2012,Apr,68.5,63.8,3067471,2854173,213298,7.0,WI
88,2012,May,68.5,63.7,3067402,2852787,214615,7.0,WI
89,2012,Jun,68.5,63.7,3067586,2852421,215165,7.0,WI
90,2012,Jul,68.5,63.7,3068026,2853712,214314,7.0,WI
91,2012,Aug,68.5,63.7,3068963,2856403,212560,6.9,WI
92,2012,Sep,68.4,63.7,3070787,2859838,210949,6.9,WI
93,2012,Oct,68.5,63.8,3072854,2862941,209913,6.8,WI
94,2012,Nov,68.5,63.8,3074792,2864732,210060,6.8,WI
95,2012,Dec,68.5,63.8,3076106,2864807,211299,6.9,WI
96,2013,Jan,68.4,63.7,3076445,2863647,212798,6.9,WI
97,2013,Feb,68.4,63.7,3076554,2862894,213660,6.9,WI
98,2013,Mar,68.4,63.7,3077411,2864201,213210,6.9,WI
99,2013,Apr,68.5,63.8,3079639,2868180,211459,6.9,WI
100,2013,May,68.5,63.8,3082194,2873099,209095,6.8,WI
101,2013,Jun,68.5,63.9,3083584,2876730,206854,6.7,WI
102,2013,Jul,68.4,63.9,3083217,2878077,205140,6.7,WI
103,2013,Aug,68.3,63.8,3080977,2877730,203247,6.6,WI
104,2013,Sep,68.2,63.8,3077408,2877039,200369,6.5,WI
105,2013,Oct,68.1,63.8,3073994,2877113,196881,6.4,WI
106,2013,Nov,68.0,63.8,3071951,2878978,192973,6.3,WI
107,2013,Dec,68.0,63.8,3071403,2882705,188698,6.1,WI
108,2014,Jan,68.0,63.9,3071739,2887465,184274,6.0,WI
109,2014,Feb,68.0,64.0,3072006,2892285,179721,5.9,WI
110,2014,Mar,68.0,64.1,3072114,2896598,175516,5.7,WI
111,2014,Apr,67.9,64.1,3072178,2900257,171921,5.6,WI
112,2014,May,67.9,64.2,3072776,2904115,168661,5.5,WI
113,2014,Jun,67.9,64.3,3074787,2909425,165362,5.4,WI
114,2014,Jul,68.0,64.4,3077724,2915883,161841,5.3,WI
115,2014,Aug,68.0,64.5,3081114,2922633,158481,5.1,WI
116,2014,Sep,68.1,64.6,3084262,2928668,155594,5.0,WI
117,2014,Oct,68.1,64.7,3086117,2933222,152895,5.0,WI
118,2014,Nov,68.0,64.7,3085929,2935868,150061,4.9,WI
119,2014,Dec,68.0,64.7,3084481,2937011,147470,4.8,WI
120,2015,Jan,67.9,64.7,3082864,2937399,145465,4.7,WI
121,2015,Feb,67.9,64.7,3081614,2937529,144085,4.7,WI
122,2015,Mar,67.9,64.7,3080867,2938085,142782,4.6,WI
123,2015,Apr,67.8,64.7,3080496,2939372,141124,4.6,WI
124,2015,May,67.8,64.8,3080195,2941178,139017,4.5,WI
125,2015,Jun,67.8,64.8,3079718,2943053,136665,4.4,WI
126,2015,Jul,67.7,64.8,3079639,2945129,134510,4.4,WI
127,2015,Aug,67.7,64.8,3080585,2947761,132824,4.3,WI
128,2015,Sep,67.8,64.9,3082966,2951433,131533,4.3,WI
129,2015,Oct,67.8,65.0,3087350,2956772,130578,4.2,WI
130,2015,Nov,67.9,65.1,3093448,2963483,129965,4.2,WI
131,2015,Dec,68.1,65.2,3099913,2970598,129315,4.2,WI
132,2016,Jan,68.2,65.3,3105263,2977051,128212,4.1,WI
133,2016,Feb,68.2,65.4,3108750,2981909,126841,4.1,WI
134,2016,Mar,68.2,65.5,3110352,2984977,125375,4.0,WI
135,2016,Apr,68.2,65.5,3110891,2986761,124130,4.0,WI
136,2016,May,68.2,65.5,3111252,2987959,123293,4.0,WI
137,2016,Jun,68.2,65.5,3111805,2989047,122758,3.9,WI
138,2016,Jul,68.2,65.5,3112393,2990301,122092,3.9,WI
139,2016,Aug,68.1,65.5,3112627,2991530,121097,3.9,WI
140,2016,Sep,68.1,65.5,3112289,2992319,119970,3.9,WI
141,2016,Oct,68.0,65.4,3111091,2992589,118502,3.8,WI
142,2016,Nov,68.0,65.4,3109627,2993340,116287,3.7,WI
143,2016,Dec,67.9,65.4,3108972,2995667,113305,3.6,WI
144,2017,Jan,67.9,65.5,3127591,3017513,110078,3.5,WI
145,2017,Feb,68.0,65.6,3130948,3024224,106724,3.4,WI
146,2017,Mar,68.0,65.8,3135502,3031417,104085,3.3,WI
147,2017,Apr,68.1,65.9,3140437,3037886,102551,3.3,WI
148,2017,May,68.2,66.0,3145031,3042977,102054,3.2,WI
149,2017,Jun,68.2,66.0,3148514,3046157,102357,3.3,WI
150,2017,Jul,68.2,66.0,3150342,3047331,103011,3.3,WI
151,2017,Aug,68.2,65.9,3149928,3046854,103074,3.3,WI
152,2017,Sep,68.1,65.9,3147440,3045565,101875,3.2,WI
153,2017,Oct,68.0,65.8,3143901,3044438,99463,3.2,WI
154,2017,Nov,67.8,65.8,3140231,3043660,96571,3.1,WI
155,2017,Dec,67.8,65.7,3137416,3043620,93796,3.0,WI
156,2018,Jan,67.7,65.7,3136461,3044548,91913,2.9,WI
157,2018,Feb,67.7,65.7,3137673,3046276,91397,2.9,WI
158,2018,Mar,67.7,65.8,3139851,3047797,92054,2.9,WI
159,2018,Apr,67.7,65.7,3140847,3047708,93139,3.0,WI
160,2018,May,67.7,65.6,3139203,3045068,94135,3.0,WI
161,2018,Jun,67.5,65.5,3134897,3040232,94665,3.0,WI
162,2018,Jul,67.4,65.3,3128884,3034303,94581,3.0,WI
163,2018,Aug,67.2,65.2,3123081,3028830,94251,3.0,WI
164,2018,Sep,67.1,65.1,3118688,3024708,93980,3.0,WI
165,2018,Oct,67.0,65.0,3116260,3022414,93846,3.0,WI
166,2018,Nov,66.9,64.9,3115856,3022020,93836,3.0,WI
167,2018,Dec,66.9,64.9,3116595,3022732,93863,3.0,WI
168,2019,Jan,66.9,64.9,3117488,3023443,94045,3.0,WI
169,2019,Feb,66.9,64.9,3118324,3023843,94481,3.0,WI
170,2019,Mar,66.9,64.9,3119400,3023857,95543,3.1,WI
171,2019,Apr,66.9,64.8,3120892,3023600,97292,3.1,WI
172,2019,May,66.9,64.8,3122450,3023034,99416,3.2,WI
173,2019,Jun,66.9,64.7,3123670,3022246,101424,3.2,WI
174,2019,Jul,66.9,64.7,3124057,3021182,102875,3.3,WI
175,2019,Aug,66.8,64.6,3123466,3019981,103485,3.3,WI
176,2019,Sep,66.8,64.6,3122451,3019575,102876,3.3,WI
177,2019,Oct,66.7,64.5,3121167,3019666,101501,3.3,WI
178,2019,Nov,66.6,64.5,3119215,3019317,99898,3.2,WI
179,2019,Dec,66.5,64.4,3115518,3017165,98353,3.2,WI
180,2020,Jan,66.3,64.3,3109128,3012863,96265,3.1,WI
181,2020,Feb,66.1,64.1,3099913,3006588,93325,3.0,WI
182,2020,Mar,65.9,64.0,3089949,3000492,89457,2.9,WI
183,2020,Apr,65.8,56.5,3086650,2651917,434733,14.1,WI
184,2020,May,66.2,59.3,3102886,2779580,323306,10.4,WI
185,2020,Jun,66.0,60.3,3095484,2827842,267642,8.6,WI
186,2020,Jul,66.2,61.2,3108339,2873121,235218,7.6,WI
187,2020,Aug,66.1,62.0,3102716,2909042,193674,6.2,WI
188,2020,Sep,66.3,62.6,3113697,2937600,176097,5.7,WI
189,2020,Oct,66.3,62.9,3113061,2955887,157174,5.0,WI
190,2020,Nov,66.3,63.1,3117692,2967580,150112,4.8,WI
191,2020,Dec,66.4,63.3,3121843,2975338,146505,4.7,WI
192,2021,Jan,66.4,63.4,3122122,2981670,140452,4.5,WI
193,2021,Feb,66.5,63.6,3126624,2988260,138364,4.4,WI
194,2021,Mar,66.6,63.7,3131595,2995757,135838,4.3,WI
195,2021,Apr,66.7,63.8,3136795,3003198,133597,4.3,WI
196,2021,May,66.7,64.0,3139516,3009893,129623,4.1,WI
197,2021,Jun,66.7,64.0,3141439,3015001,126438,4.0,WI
198,2021,Jul,66.7,64.1,3140115,3019844,120271,3.8,WI
199,2021,Aug,66.6,64.2,3137702,3024602,113100,3.6,WI
200,2021,Sep,66.5,64.3,3135470,3030203,105267,3.4,WI
201,2021,Oct,66.4,64.3,3134799,3035515,99284,3.2,WI
202,2021,Nov,66.4,64.3,3134692,3037765,96927,3.1,WI
203,2021,Dec,66.4,64.3,3135065,3038524,96541,3.1,WI
204,2022,Jan,66.4,64.4,3137011,3043904,93107,3.0,WI
205,2022,Feb,66.4,64.5,3139677,3048899,90778,2.9,WI
206,2022,Mar,66.5,64.6,3144736,3056210,88526,2.8,WI
207,2022,Apr,66.5,64.6,3147274,3058009,89265,2.8,WI
208,2022,May,66.5,64.6,3149172,3059272,89900,2.9,WI
209,2022,Jun,66.4,64.5,3144351,3052658,91693,2.9,WI
210,2022,Jul,66.2,64.2,3135489,3042081,93408,3.0,WI
211,2022,Aug,65.9,63.9,3125558,3029295,96263,3.1,WI
212,2022,Sep,65.6,63.5,3113798,3013912,99886,3.2,WI
213,2022,Oct,65.3,63.1,3098462,2996377,102085,3.3,WI
214,2022,Nov,64.9,62.8,3084800,2982684,102116,3.3,WI
0,2005,Jan,67.4,63.5,3223554,3033132,190422,5.9,WA
1,2005,Feb,67.5,63.5,3229985,3040798,189187,5.9,WA
2,2005,Mar,67.6,63.7,3236835,3049422,187413,5.8,WA
3,2005,Apr,67.6,63.8,3244311,3058875,185436,5.7,WA
4,2005,May,67.7,63.9,3252288,3068571,183717,5.6,WA
5,2005,Jun,67.8,64.0,3260163,3077493,182670,5.6,WA
6,2005,Jul,67.8,64.0,3267255,3084845,182410,5.6,WA
7,2005,Aug,67.8,64.1,3272992,3090829,182163,5.6,WA
8,2005,Sep,67.8,64.1,3277523,3096373,181150,5.5,WA
9,2005,Oct,67.7,64.0,3281368,3102575,178793,5.4,WA
10,2005,Nov,67.7,64.0,3285007,3109758,175249,5.3,WA
11,2005,Dec,67.6,64.1,3288548,3117441,171107,5.2,WA
12,2006,Jan,67.6,64.1,3292718,3125422,167296,5.1,WA
13,2006,Feb,67.6,64.2,3297951,3133200,164751,5.0,WA
14,2006,Mar,67.6,64.2,3304104,3140073,164031,5.0,WA
15,2006,Apr,67.6,64.3,3311209,3146142,165067,5.0,WA
16,2006,May,67.7,64.3,3318875,3152061,166814,5.0,WA
17,2006,Jun,67.7,64.3,3326358,3158117,168241,5.1,WA
18,2006,Jul,67.8,64.3,3333760,3165012,168748,5.1,WA
19,2006,Aug,67.8,64.4,3341319,3172753,168566,5.0,WA
20,2006,Sep,67.8,64.4,3348767,3180801,167966,5.0,WA
21,2006,Oct,67.9,64.5,3355850,3189139,166711,5.0,WA
22,2006,Nov,67.9,64.6,3362320,3197583,164737,4.9,WA
23,2006,Dec,67.9,64.6,3367727,3205651,162076,4.8,WA
24,2007,Jan,67.9,64.7,3371978,3213005,158973,4.7,WA
25,2007,Feb,67.9,64.7,3375862,3219836,156026,4.6,WA
26,2007,Mar,67.9,64.8,3379685,3226114,153571,4.5,WA
27,2007,Apr,67.8,64.8,3383635,3231633,152002,4.5,WA
28,2007,May,67.8,64.8,3388302,3236416,151886,4.5,WA
29,2007,Jun,67.9,64.8,3394186,3241007,153179,4.5,WA
30,2007,Jul,67.9,64.8,3401159,3245815,155344,4.6,WA
31,2007,Aug,68.0,64.8,3409111,3251381,157730,4.6,WA
32,2007,Sep,68.0,64.9,3417771,3258296,159475,4.7,WA
33,2007,Oct,68.1,64.9,3426353,3266024,160329,4.7,WA
34,2007,Nov,68.2,65.0,3434198,3274082,160116,4.7,WA
35,2007,Dec,68.2,65.0,3441083,3281863,159220,4.6,WA
36,2008,Jan,68.2,65.1,3446781,3288083,158698,4.6,WA
37,2008,Feb,68.2,65.1,3451561,3292130,159431,4.6,WA
38,2008,Mar,68.3,65.1,3456754,3294563,162191,4.7,WA
39,2008,Apr,68.3,65.0,3463341,3296358,166983,4.8,WA
40,2008,May,68.4,65.0,3470993,3297939,173054,5.0,WA
41,2008,Jun,68.4,64.9,3478758,3299349,179409,5.2,WA
42,2008,Jul,68.5,64.8,3485255,3300237,185018,5.3,WA
43,2008,Aug,68.4,64.7,3489319,3299643,189676,5.4,WA
44,2008,Sep,68.4,64.5,3490731,3296178,194553,5.6,WA
45,2008,Oct,68.2,64.3,3490210,3288871,201339,5.8,WA
46,2008,Nov,68.1,64.0,3488288,3277136,211152,6.1,WA
47,2008,Dec,67.9,63.6,3485137,3261532,223605,6.4,WA
48,2009,Jan,67.8,63.2,3480693,3243615,237078,6.8,WA
49,2009,Feb,67.6,62.7,3474872,3225423,249449,7.2,WA
50,2009,Mar,67.3,62.3,3467544,3209014,258530,7.5,WA
51,2009,Apr,67.2,62.0,3467492,3195574,271918,7.8,WA
52,2009,May,67.1,61.7,3466388,3185132,281256,8.1,WA
53,2009,Jun,67.0,61.4,3464827,3176939,287888,8.3,WA
54,2009,Jul,66.9,61.2,3463333,3169356,293977,8.5,WA
55,2009,Aug,66.8,61.0,3462571,3161327,301244,8.7,WA
56,2009,Sep,66.7,60.7,3463071,3152726,310345,9.0,WA
57,2009,Oct,66.5,60.5,3456236,3143906,312330,9.0,WA
58,2009,Nov,66.3,60.3,3451994,3136631,315363,9.1,WA
59,2009,Dec,66.2,60.1,3451532,3132862,318670,9.2,WA
60,2010,Jan,66.2,60.1,3454420,3133335,321085,9.3,WA
61,2010,Feb,66.2,60.1,3458632,3136999,321633,9.3,WA
62,2010,Mar,66.2,60.1,3462164,3141865,320299,9.3,WA
63,2010,Apr,66.2,60.1,3463843,3146041,317802,9.2,WA
64,2010,May,66.1,60.1,3463335,3148394,314941,9.1,WA
65,2010,Jun,66.0,60.1,3461303,3148334,312969,9.0,WA
66,2010,Jul,65.9,60.0,3458973,3146426,312547,9.0,WA
67,2010,Aug,65.8,59.9,3457191,3143795,313396,9.1,WA
68,2010,Sep,65.7,59.7,3456058,3141316,314742,9.1,WA
69,2010,Oct,65.6,59.6,3455291,3139893,315398,9.1,WA
70,2010,Nov,65.5,59.6,3453762,3139343,314419,9.1,WA
71,2010,Dec,65.4,59.5,3450811,3139125,311686,9.0,WA
72,2011,Jan,65.3,59.4,3447125,3139152,307973,8.9,WA
73,2011,Feb,65.1,59.4,3443437,3139149,304288,8.8,WA
74,2011,Mar,65.0,59.3,3440138,3139014,301124,8.8,WA
75,2011,Apr,64.9,59.3,3437612,3138956,298656,8.7,WA
76,2011,May,64.8,59.2,3436211,3139194,297017,8.6,WA
77,2011,Jun,64.7,59.2,3435558,3139899,295659,8.6,WA
78,2011,Jul,64.7,59.1,3434917,3141096,293821,8.6,WA
79,2011,Aug,64.6,59.1,3434295,3143050,291245,8.5,WA
80,2011,Sep,64.5,59.1,3434445,3146622,287823,8.4,WA
81,2011,Oct,64.4,59.1,3436373,3152344,284029,8.3,WA
82,2011,Nov,64.4,59.2,3440275,3159925,280350,8.1,WA
83,2011,Dec,64.5,59.3,3445721,3168491,277230,8.0,WA
84,2012,Jan,64.5,59.4,3452355,3177413,274942,8.0,WA
85,2012,Feb,64.6,59.5,3459848,3185999,273849,7.9,WA
86,2012,Mar,64.7,59.6,3466956,3192664,274292,7.9,WA
87,2012,Apr,64.7,59.6,3472271,3196410,275861,7.9,WA
88,2012,May,64.7,59.5,3475950,3198232,277718,8.0,WA
89,2012,Jun,64.7,59.5,3478835,3199945,278890,8.0,WA
90,2012,Jul,64.5,59.5,3475293,3203044,272249,7.8,WA
91,2012,Aug,64.4,59.5,3472450,3207615,264835,7.6,WA
92,2012,Sep,64.3,59.5,3470187,3212569,257618,7.4,WA
93,2012,Oct,64.2,59.6,3467617,3216647,250970,7.2,WA
94,2012,Nov,64.1,59.6,3464221,3219140,245081,7.1,WA
95,2012,Dec,64.0,59.5,3459702,3219911,239791,6.9,WA
96,2013,Jan,63.9,59.5,3457127,3219092,238035,6.9,WA
97,2013,Feb,63.6,59.4,3447914,3217874,230040,6.7,WA
98,2013,Mar,63.6,59.4,3449293,3218064,231229,6.7,WA
99,2013,Apr,63.6,59.4,3452380,3220670,231710,6.7,WA
100,2013,May,63.6,59.4,3456355,3224598,231757,6.7,WA
101,2013,Jun,63.7,59.4,3460427,3228621,231806,6.7,WA
102,2013,Jul,63.7,59.4,3464183,3232372,231811,6.7,WA
103,2013,Aug,63.6,59.4,3466584,3235962,230622,6.7,WA
104,2013,Sep,63.6,59.4,3467375,3239639,227736,6.6,WA
105,2013,Oct,63.5,59.4,3467791,3243553,224238,6.5,WA
106,2013,Nov,63.4,59.4,3468654,3247718,220936,6.4,WA
107,2013,Dec,63.4,59.4,3469934,3251784,218150,6.3,WA
108,2014,Jan,63.3,59.4,3471141,3255449,215692,6.2,WA
109,2014,Feb,63.2,59.4,3471891,3258702,213189,6.1,WA
110,2014,Mar,63.2,59.4,3472850,3261947,210903,6.1,WA
111,2014,Apr,63.1,59.3,3474684,3265637,209047,6.0,WA
112,2014,May,63.1,59.4,3478313,3270893,207420,6.0,WA
113,2014,Jun,63.2,59.4,3484570,3278515,206055,5.9,WA
114,2014,Jul,63.2,59.5,3493179,3287937,205242,5.9,WA
115,2014,Aug,63.3,59.6,3503437,3298328,205109,5.9,WA
116,2014,Sep,63.4,59.7,3513688,3308405,205283,5.8,WA
117,2014,Oct,63.4,59.8,3521452,3316839,204613,5.8,WA
118,2014,Nov,63.4,59.8,3525535,3323022,202513,5.7,WA
119,2014,Dec,63.4,59.8,3527147,3327558,199589,5.7,WA
120,2015,Jan,63.3,59.8,3528211,3331515,196696,5.6,WA
121,2015,Feb,63.3,59.8,3530246,3335608,194638,5.5,WA
122,2015,Mar,63.2,59.8,3533904,3340601,193303,5.5,WA
123,2015,Apr,63.2,59.8,3539114,3346743,192371,5.4,WA
124,2015,May,63.3,59.8,3544965,3353329,191636,5.4,WA
125,2015,Jun,63.3,59.8,3550112,3359187,190925,5.4,WA
126,2015,Jul,63.2,59.8,3554656,3363984,190672,5.4,WA
127,2015,Aug,63.2,59.8,3559448,3368239,191209,5.4,WA
128,2015,Sep,63.2,59.8,3565425,3373358,192067,5.4,WA
129,2015,Oct,63.2,59.8,3573801,3380768,193033,5.4,WA
130,2015,Nov,63.3,59.9,3585005,3390788,194217,5.4,WA
131,2015,Dec,63.5,60.0,3597830,3402683,195147,5.4,WA
132,2016,Jan,63.6,60.1,3610474,3415138,195336,5.4,WA
133,2016,Feb,63.7,60.2,3621594,3426657,194937,5.4,WA
134,2016,Mar,63.7,60.3,3630389,3436155,194234,5.4,WA
135,2016,Apr,63.7,60.3,3637282,3443618,193664,5.3,WA
136,2016,May,63.7,60.4,3643393,3449983,193410,5.3,WA
137,2016,Jun,63.7,60.4,3649388,3456222,193166,5.3,WA
138,2016,Jul,63.7,60.4,3655019,3462950,192069,5.3,WA
139,2016,Aug,63.7,60.4,3660154,3470082,190072,5.2,WA
140,2016,Sep,63.7,60.4,3665002,3477143,187859,5.1,WA
141,2016,Oct,63.6,60.4,3669217,3483903,185314,5.1,WA
142,2016,Nov,63.6,60.4,3673004,3490923,182081,5.0,WA
143,2016,Dec,63.6,60.5,3677076,3498667,178409,4.9,WA
144,2017,Jan,63.5,60.5,3683980,3508124,175856,4.8,WA
145,2017,Feb,63.5,60.6,3692432,3519115,173317,4.7,WA
146,2017,Mar,63.6,60.7,3701462,3530103,171359,4.6,WA
147,2017,Apr,63.7,60.7,3710929,3540606,170323,4.6,WA
148,2017,May,63.7,60.8,3720366,3550246,170120,4.6,WA
149,2017,Jun,63.8,60.9,3729167,3558488,170679,4.6,WA
150,2017,Jul,63.8,60.9,3737064,3565091,171973,4.6,WA
151,2017,Aug,63.8,60.9,3743266,3569864,173402,4.6,WA
152,2017,Sep,63.8,60.8,3747314,3572996,174318,4.7,WA
153,2017,Oct,63.8,60.8,3749967,3575464,174503,4.7,WA
154,2017,Nov,63.7,60.7,3752292,3578113,174179,4.6,WA
155,2017,Dec,63.7,60.7,3755898,3582546,173352,4.6,WA
156,2018,Jan,63.7,60.8,3762253,3589986,172267,4.6,WA
157,2018,Feb,63.8,60.9,3771896,3600816,171080,4.5,WA
158,2018,Mar,63.9,61.1,3783539,3613911,169628,4.5,WA
159,2018,Apr,64.0,61.2,3794549,3626875,167674,4.4,WA
160,2018,May,64.1,61.3,3803383,3637673,165710,4.4,WA
161,2018,Jun,64.1,61.4,3810268,3645916,164352,4.3,WA
162,2018,Jul,64.2,61.4,3816067,3652014,164053,4.3,WA
163,2018,Aug,64.2,61.4,3822311,3657256,165055,4.3,WA
164,2018,Sep,64.2,61.4,3830474,3662891,167583,4.4,WA
165,2018,Oct,64.3,61.5,3841402,3669976,171426,4.5,WA
166,2018,Nov,64.5,61.5,3854917,3679076,175841,4.6,WA
167,2018,Dec,64.7,61.7,3869712,3690142,179570,4.6,WA
168,2019,Jan,64.8,61.8,3883899,3702409,181490,4.7,WA
169,2019,Feb,65.0,61.9,3896006,3715201,180805,4.6,WA
170,2019,Mar,65.1,62.1,3905927,3727804,178123,4.6,WA
171,2019,Apr,65.1,62.2,3914391,3740050,174341,4.5,WA
172,2019,May,65.2,62.3,3922050,3751539,170511,4.3,WA
173,2019,Jun,65.2,62.4,3929697,3762081,167616,4.3,WA
174,2019,Jul,65.3,62.5,3937815,3771747,166068,4.2,WA
175,2019,Aug,65.3,62.6,3946568,3780993,165575,4.2,WA
176,2019,Sep,65.4,62.7,3955947,3791321,164626,4.2,WA
177,2019,Oct,65.5,62.8,3964903,3802470,162433,4.1,WA
178,2019,Nov,65.5,62.9,3971935,3813191,158744,4.0,WA
179,2019,Dec,65.5,62.9,3975706,3820633,155073,3.9,WA
180,2020,Jan,65.4,62.9,3976695,3823183,153512,3.9,WA
181,2020,Feb,65.4,62.8,3976464,3821069,155395,3.9,WA
182,2020,Mar,64.9,61.5,3953738,3744680,209058,5.3,WA
183,2020,Apr,66.5,55.3,4051077,3372313,678764,16.8,WA
184,2020,May,65.2,56.6,3978036,3451334,526702,13.2,WA
185,2020,Jun,64.4,57.1,3929414,3483182,446232,11.4,WA
186,2020,Jul,64.1,57.6,3918804,3519222,399582,10.2,WA
187,2020,Aug,63.6,58.0,3885396,3547912,337484,8.7,WA
188,2020,Sep,63.5,58.4,3882048,3574600,307448,7.9,WA
189,2020,Oct,63.2,58.7,3866641,3591665,274976,7.1,WA
190,2020,Nov,63.1,58.9,3864297,3604529,259768,6.7,WA
191,2020,Dec,63.1,59.0,3867742,3614843,252899,6.5,WA
192,2021,Jan,63.1,59.2,3866736,3624667,242069,6.3,WA
193,2021,Feb,63.1,59.3,3871096,3636626,234470,6.1,WA
194,2021,Mar,63.2,59.5,3877979,3651185,226794,5.8,WA
195,2021,Apr,63.4,59.8,3886772,3666574,220198,5.7,WA
196,2021,May,63.4,60.0,3894512,3681350,213162,5.5,WA
197,2021,Jun,63.6,60.2,3906118,3696525,209593,5.4,WA
198,2021,Jul,63.7,60.4,3916761,3712969,203792,5.2,WA
199,2021,Aug,63.9,60.7,3929320,3731837,197483,5.0,WA
200,2021,Sep,64.0,60.9,3939003,3749589,189414,4.8,WA
201,2021,Oct,64.1,61.1,3947637,3765399,182238,4.6,WA
202,2021,Nov,64.0,61.1,3946180,3767745,178435,4.5,WA
203,2021,Dec,63.9,61.1,3943843,3766702,177141,4.5,WA
204,2022,Jan,64.2,61.4,3960412,3786553,173859,4.4,WA
205,2022,Feb,64.5,61.7,3981799,3811683,170116,4.3,WA
206,2022,Mar,64.8,62.1,4002973,3837211,165762,4.1,WA
207,2022,Apr,65.1,62.4,4023291,3860300,162991,4.1,WA
208,2022,May,65.2,62.7,4036014,3877391,158623,3.9,WA
209,2022,Jun,65.2,62.7,4038939,3883584,155355,3.8,WA
210,2022,Jul,65.0,62.6,4030448,3881385,149063,3.7,WA
211,2022,Aug,64.8,62.4,4020402,3871160,149242,3.7,WA
212,2022,Sep,64.7,62.2,4012023,3862123,149900,3.7,WA
213,2022,Oct,64.5,62.1,4007898,3854382,153516,3.8,WA
214,2022,Nov,64.4,61.8,4003419,3842331,161088,4.0,WA
0,2005,Jan,67.0,63.3,3172050,2994570,177480,5.6,IN
1,2005,Feb,67.1,63.3,3177325,3000375,176950,5.6,IN
2,2005,Mar,67.1,63.4,3182356,3007192,175164,5.5,IN
3,2005,Apr,67.2,63.6,3187599,3014773,172826,5.4,IN
4,2005,May,67.3,63.7,3193454,3022717,170737,5.3,IN
5,2005,Jun,67.4,63.8,3199884,3030220,169664,5.3,IN
6,2005,Jul,67.5,63.9,3206552,3036250,170302,5.3,IN
7,2005,Aug,67.5,63.9,3212832,3040900,171932,5.4,IN
8,2005,Sep,67.6,64.0,3218431,3045291,173140,5.4,IN
9,2005,Oct,67.6,64.0,3223149,3050395,172754,5.4,IN
10,2005,Nov,67.6,64.0,3226653,3056076,170577,5.3,IN
11,2005,Dec,67.6,64.1,3228693,3061470,167223,5.2,IN
12,2006,Jan,67.6,64.2,3230070,3066477,163593,5.1,IN
13,2006,Feb,67.6,64.2,3231598,3070849,160749,5.0,IN
14,2006,Mar,67.6,64.2,3233382,3073794,159588,4.9,IN
15,2006,Apr,67.6,64.2,3234908,3074689,160219,5.0,IN
16,2006,May,67.5,64.2,3235765,3073913,161852,5.0,IN
17,2006,Jun,67.5,64.1,3235953,3072514,163439,5.1,IN
18,2006,Jul,67.5,64.0,3236278,3072207,164071,5.1,IN
19,2006,Aug,67.4,64.0,3237482,3073727,163755,5.1,IN
20,2006,Sep,67.4,64.0,3238710,3075872,162838,5.0,IN
21,2006,Oct,67.4,64.0,3239074,3078111,160963,5.0,IN
22,2006,Nov,67.3,64.0,3238109,3079821,158288,4.9,IN
23,2006,Dec,67.2,64.0,3234565,3079521,155044,4.8,IN
24,2007,Jan,67.0,63.8,3227858,3076193,151665,4.7,IN
25,2007,Feb,66.8,63.7,3218753,3070366,148387,4.6,IN
26,2007,Mar,66.5,63.5,3208405,3063073,145332,4.5,IN
27,2007,Apr,66.3,63.3,3198676,3055662,143014,4.5,IN
28,2007,May,66.1,63.1,3191090,3049045,142045,4.5,IN
29,2007,Jun,65.9,63.0,3186811,3044087,142724,4.5,IN
30,2007,Jul,65.9,62.9,3186509,3041603,144906,4.5,IN
31,2007,Aug,65.9,62.8,3189936,3042056,147880,4.6,IN
32,2007,Sep,66.0,62.9,3196416,3045872,150544,4.7,IN
33,2007,Oct,66.1,62.9,3204215,3051752,152463,4.8,IN
34,2007,Nov,66.2,63.0,3211460,3058115,153345,4.8,IN
35,2007,Dec,66.3,63.1,3217636,3064296,153340,4.8,IN
36,2008,Jan,66.3,63.2,3222317,3068926,153391,4.8,IN
37,2008,Feb,66.4,63.2,3225717,3071079,154638,4.8,IN
38,2008,Mar,66.4,63.2,3229511,3071330,158181,4.9,IN
39,2008,Apr,66.5,63.1,3234611,3070463,164148,5.1,IN
40,2008,May,66.6,63.0,3241131,3069326,171805,5.3,IN
41,2008,Jun,66.7,63.0,3248295,3068270,180025,5.5,IN
42,2008,Jul,66.7,62.9,3254256,3066171,188085,5.8,IN
43,2008,Aug,66.8,62.7,3257956,3061005,196951,6.0,IN
44,2008,Sep,66.8,62.5,3259403,3050821,208582,6.4,IN
45,2008,Oct,66.7,62.1,3259393,3034749,224644,6.9,IN
46,2008,Nov,66.7,61.6,3258489,3013159,245330,7.5,IN
47,2008,Dec,66.6,61.1,3257127,2987719,269408,8.3,IN
48,2009,Jan,66.5,60.5,3256297,2961664,294633,9.0,IN
49,2009,Feb,66.5,60.0,3255885,2937994,317891,9.8,IN
50,2009,Mar,66.4,59.6,3254065,2918351,335714,10.3,IN
51,2009,Apr,66.3,59.3,3249511,2903308,346203,10.7,IN
52,2009,May,66.1,59.0,3241440,2891493,349947,10.8,IN
53,2009,Jun,65.9,58.7,3229982,2881080,348902,10.8,IN
54,2009,Jul,65.5,58.5,3216060,2870731,345329,10.7,IN
55,2009,Aug,65.2,58.2,3201118,2860122,340996,10.7,IN
56,2009,Sep,64.9,58.0,3187111,2849830,337281,10.6,IN
57,2009,Oct,64.6,57.8,3175581,2840309,335272,10.6,IN
58,2009,Nov,64.4,57.6,3168554,2833101,335453,10.6,IN
59,2009,Dec,64.3,57.5,3167003,2829818,337185,10.6,IN
60,2010,Jan,64.3,57.5,3169128,2830634,338494,10.7,IN
61,2010,Feb,64.4,57.5,3172852,2834812,338040,10.7,IN
62,2010,Mar,64.5,57.6,3177346,2841624,335722,10.6,IN
63,2010,Apr,64.1,57.4,3181319,2849394,331925,10.4,IN
64,2010,May,64.1,57.5,3183430,2856480,326950,10.3,IN
65,2010,Jun,64.1,57.6,3183185,2861326,321859,10.1,IN
66,2010,Jul,64.0,57.6,3180859,2863150,317709,10.0,IN
67,2010,Aug,63.9,57.6,3177460,2862980,314480,9.9,IN
68,2010,Sep,63.8,57.5,3173755,2862333,311422,9.8,IN
69,2010,Oct,63.7,57.5,3170742,2863424,307318,9.7,IN
70,2010,Nov,63.6,57.5,3168580,2867137,301443,9.5,IN
71,2010,Dec,63.5,57.6,3167428,2873191,294237,9.3,IN
72,2011,Jan,63.5,57.7,3168166,2881081,287085,9.1,IN
73,2011,Feb,63.5,57.9,3170670,2889335,281335,8.9,IN
74,2011,Mar,63.6,58.0,3173805,2895813,277992,8.8,IN
75,2011,Apr,63.6,58.0,3177281,2899609,277672,8.7,IN
76,2011,May,63.7,58.0,3181683,2901364,280319,8.8,IN
77,2011,Jun,63.7,58.0,3186877,2902198,284679,8.9,IN
78,2011,Jul,63.8,58.0,3192548,2903557,288991,9.1,IN
79,2011,Aug,63.9,58.0,3197873,2906147,291726,9.1,IN
80,2011,Sep,63.9,58.1,3201966,2910302,291664,9.1,IN
81,2011,Oct,63.9,58.2,3204480,2915887,288593,9.0,IN
82,2011,Nov,63.9,58.3,3204528,2921443,283085,8.8,IN
83,2011,Dec,63.8,58.3,3201486,2925295,276191,8.6,IN
84,2012,Jan,63.7,58.3,3195782,2926439,269343,8.4,IN
85,2012,Feb,63.5,58.2,3188573,2924640,263933,8.3,IN
86,2012,Mar,63.3,58.1,3180618,2919810,260808,8.2,IN
87,2012,Apr,63.1,58.0,3172844,2913076,259768,8.2,IN
88,2012,May,63.0,57.8,3166824,2906905,259919,8.2,IN
89,2012,Jun,62.9,57.7,3163404,2903332,260072,8.2,IN
90,2012,Jul,62.8,57.7,3162320,2902854,259466,8.2,IN
91,2012,Aug,62.8,57.7,3163313,2904676,258637,8.2,IN
92,2012,Sep,62.8,57.7,3166249,2907739,258510,8.2,IN
93,2012,Oct,62.9,57.7,3169729,2910539,259190,8.2,IN
94,2012,Nov,62.9,57.7,3172886,2912626,260260,8.2,IN
95,2012,Dec,62.9,57.7,3175152,2914128,261024,8.2,IN
96,2013,Jan,62.9,57.7,3176337,2915330,261007,8.2,IN
97,2013,Feb,62.9,57.7,3177057,2917239,259818,8.2,IN
98,2013,Mar,62.9,57.8,3178518,2921428,257090,8.1,IN
99,2013,Apr,62.9,57.9,3181648,2928625,253023,8.0,IN
100,2013,May,63.0,58.1,3185716,2937252,248464,7.8,IN
101,2013,Jun,63.0,58.2,3190582,2946381,244201,7.7,IN
102,2013,Jul,63.1,58.4,3196530,2956324,240206,7.5,IN
103,2013,Aug,63.2,58.5,3201733,2966614,235119,7.3,IN
104,2013,Sep,63.2,58.7,3204516,2976182,228334,7.1,IN
105,2013,Oct,63.2,58.8,3205501,2984597,220904,6.9,IN
106,2013,Nov,63.2,58.9,3206192,2992216,213976,6.7,IN
107,2013,Dec,63.2,59.1,3207647,2999291,208356,6.5,IN
108,2014,Jan,63.2,59.2,3210348,3006208,204140,6.4,IN
109,2014,Feb,63.2,59.3,3214183,3013026,201157,6.3,IN
110,2014,Mar,63.3,59.4,3218859,3019531,199328,6.2,IN
111,2014,Apr,63.4,59.5,3222985,3024974,198011,6.1,IN
112,2014,May,63.4,59.5,3226182,3030027,196155,6.1,IN
113,2014,Jun,63.4,59.6,3228715,3035235,193480,6.0,IN
114,2014,Jul,63.4,59.7,3230459,3039980,190479,5.9,IN
115,2014,Aug,63.4,59.7,3233023,3044917,188106,5.8,IN
116,2014,Sep,63.5,59.8,3237161,3050703,186458,5.8,IN
117,2014,Oct,63.5,59.9,3241264,3056667,184597,5.7,IN
118,2014,Nov,63.5,60.0,3243507,3061704,181803,5.6,IN
119,2014,Dec,63.5,60.0,3243867,3065804,178063,5.5,IN
120,2015,Jan,63.5,60.1,3243609,3069876,173733,5.4,IN
121,2015,Feb,63.5,60.2,3243958,3074662,169296,5.2,IN
122,2015,Mar,63.5,60.3,3245723,3080816,164907,5.1,IN
123,2015,Apr,63.6,60.4,3249285,3088493,160792,4.9,IN
124,2015,May,63.6,60.6,3254041,3096911,157130,4.8,IN
125,2015,Jun,63.7,60.7,3258941,3105042,153899,4.7,IN
126,2015,Jul,63.8,60.8,3264081,3112811,151270,4.6,IN
127,2015,Aug,63.9,60.9,3269717,3120334,149383,4.6,IN
128,2015,Sep,64.0,61.1,3276546,3128292,148254,4.5,IN
129,2015,Oct,64.1,61.2,3286118,3137870,148248,4.5,IN
130,2015,Nov,64.3,61.4,3298722,3149094,149628,4.5,IN
131,2015,Dec,64.6,61.6,3312477,3160677,151800,4.6,IN
132,2016,Jan,64.8,61.8,3324395,3170641,153754,4.6,IN
133,2016,Feb,64.9,61.9,3332857,3178012,154845,4.6,IN
134,2016,Mar,65.0,61.9,3337674,3183002,154672,4.6,IN
135,2016,Apr,65.0,62.0,3339764,3186380,153384,4.6,IN
136,2016,May,64.9,62.0,3340290,3189022,151268,4.5,IN
137,2016,Jun,64.9,62.0,3339805,3191314,148491,4.4,IN
138,2016,Jul,64.8,62.0,3338179,3192914,145265,4.4,IN
139,2016,Aug,64.7,62.0,3335426,3193276,142150,4.3,IN
140,2016,Sep,64.6,61.9,3331610,3191886,139724,4.2,IN
141,2016,Oct,64.5,61.8,3326557,3188983,137574,4.1,IN
142,2016,Nov,64.4,61.7,3321175,3186375,134800,4.1,IN
143,2016,Dec,64.3,61.7,3317083,3185941,131142,4.0,IN
144,2017,Jan,64.1,61.7,3320460,3193478,126982,3.8,IN
145,2017,Feb,64.1,61.8,3321490,3199571,121919,3.7,IN
146,2017,Mar,64.2,61.9,3324093,3206656,117437,3.5,IN
147,2017,Apr,64.2,62.0,3327805,3213301,114504,3.4,IN
148,2017,May,64.3,62.1,3331884,3218341,113543,3.4,IN
149,2017,Jun,64.3,62.1,3335421,3221008,114413,3.4,IN
150,2017,Jul,64.3,62.1,3338155,3221914,116241,3.5,IN
151,2017,Aug,64.3,62.0,3339376,3221848,117528,3.5,IN
152,2017,Sep,64.2,62.0,3338942,3221577,117365,3.5,IN
153,2017,Oct,64.2,62.0,3338238,3222593,115645,3.5,IN
154,2017,Nov,64.2,62.0,3338651,3225487,113164,3.4,IN
155,2017,Dec,64.2,62.1,3341850,3231082,110768,3.3,IN
156,2018,Jan,64.3,62.2,3349148,3239726,109422,3.3,IN
157,2018,Feb,64.5,62.4,3360798,3251217,109581,3.3,IN
158,2018,Mar,64.7,62.6,3375039,3264056,110983,3.3,IN
159,2018,Apr,65.0,62.8,3388144,3275366,112778,3.3,IN
160,2018,May,65.1,62.9,3397146,3282686,114460,3.4,IN
161,2018,Jun,65.1,62.9,3401133,3285345,115788,3.4,IN
162,2018,Jul,65.1,62.8,3400096,3283445,116651,3.4,IN
163,2018,Aug,65.0,62.7,3396268,3278925,117343,3.5,IN
164,2018,Sep,64.8,62.6,3392436,3274280,118156,3.5,IN
165,2018,Oct,64.8,62.5,3390415,3271337,119078,3.5,IN
166,2018,Nov,64.7,62.4,3391347,3271490,119857,3.5,IN
167,2018,Dec,64.8,62.5,3393902,3274242,119660,3.5,IN
168,2019,Jan,64.8,62.5,3395581,3277560,118021,3.5,IN
169,2019,Feb,64.7,62.5,3394752,3279698,115054,3.4,IN
170,2019,Mar,64.6,62.5,3391727,3279987,111740,3.3,IN
171,2019,Apr,64.5,62.5,3388261,3279236,109025,3.2,IN
172,2019,May,64.4,62.4,3385691,3278133,107558,3.2,IN
173,2019,Jun,64.4,62.3,3384943,3277535,107408,3.2,IN
174,2019,Jul,64.4,62.3,3386745,3278223,108522,3.2,IN
175,2019,Aug,64.4,62.3,3390517,3280293,110224,3.3,IN
176,2019,Sep,64.5,62.3,3395468,3284192,111276,3.3,IN
177,2019,Oct,64.5,62.4,3400039,3288340,111699,3.3,IN
178,2019,Nov,64.5,62.4,3401751,3289902,111849,3.3,IN
179,2019,Dec,64.4,62.3,3399350,3286765,112585,3.3,IN
180,2020,Jan,64.3,62.1,3392684,3278899,113785,3.4,IN
181,2020,Feb,64.0,61.9,3381598,3266921,114677,3.4,IN
182,2020,Mar,62.5,60.3,3301107,3186840,114267,3.5,IN
183,2020,Apr,60.8,50.6,3215828,2675425,540403,16.8,IN
184,2020,May,62.2,54.5,3285590,2880318,405272,12.3,IN
185,2020,Jun,62.3,55.9,3291193,2954875,336318,10.2,IN
186,2020,Jul,62.8,57.2,3318743,3025195,293548,8.8,IN
187,2020,Aug,62.7,58.2,3319412,3081234,238178,7.2,IN
188,2020,Sep,63.1,59.1,3337823,3126233,211590,6.3,IN
189,2020,Oct,63.0,59.6,3337720,3154581,183139,5.5,IN
190,2020,Nov,63.0,59.8,3341055,3171442,169613,5.1,IN
191,2020,Dec,63.0,60.0,3341005,3180196,160809,4.8,IN
192,2021,Jan,62.9,60.1,3334847,3185199,149648,4.5,IN
193,2021,Feb,62.9,60.2,3334943,3190228,144715,4.3,IN
194,2021,Mar,62.9,60.3,3337111,3196521,140590,4.2,IN
195,2021,Apr,62.9,60.3,3340145,3202244,137901,4.1,IN
196,2021,May,62.9,60.4,3339151,3205510,133641,4.0,IN
197,2021,Jun,62.8,60.3,3335236,3204945,130291,3.9,IN
198,2021,Jul,62.6,60.2,3325483,3202867,122616,3.7,IN
199,2021,Aug,62.3,60.2,3313881,3201181,112700,3.4,IN
200,2021,Sep,62.1,60.2,3304180,3202775,101405,3.1,IN
201,2021,Oct,61.9,60.2,3299997,3207432,92565,2.8,IN
202,2021,Nov,61.9,60.2,3301190,3212045,89145,2.7,IN
203,2021,Dec,61.9,60.3,3303425,3214734,88691,2.7,IN
204,2022,Jan,61.9,60.4,3304817,3224824,79993,2.4,IN
205,2022,Feb,62.1,60.7,3315935,3240603,75332,2.3,IN
206,2022,Mar,62.4,61.0,3332430,3260410,72020,2.2,IN
207,2022,Apr,62.6,61.3,3347991,3275693,72298,2.2,IN
208,2022,May,62.9,61.5,3364701,3290663,74038,2.2,IN
209,2022,Jun,63.1,61.6,3378537,3298597,79940,2.4,IN
210,2022,Jul,63.4,61.7,3393932,3305918,88014,2.6,IN
211,2022,Aug,63.4,61.7,3401743,3306525,95218,2.8,IN
212,2022,Sep,63.4,61.6,3401059,3304212,96847,2.8,IN
213,2022,Oct,63.3,61.4,3397398,3296962,100436,3.0,IN
214,2022,Nov,63.2,61.3,3394935,3292041,102894,3.0,IN
0,2005,Jan,67.4,63.5,11104720,10460250,644470,5.8,TC
1,2005,Feb,67.4,63.5,11116844,10480729,636115,5.7,TC
2,2005,Mar,67.3,63.6,11125846,10502785,623061,5.6,TC
3,2005,Apr,67.3,63.6,11134783,10525682,609101,5.5,TC
4,2005,May,67.3,63.7,11147039,10548719,598320,5.4,TC
5,2005,Jun,67.3,63.7,11163389,10569961,593428,5.3,TC
6,2005,Jul,67.3,63.7,11181941,10586526,595415,5.3,TC
7,2005,Aug,67.2,63.6,11198913,10597585,601328,5.4,TC
8,2005,Sep,67.0,63.4,11211963,10604917,607046,5.4,TC
9,2005,Oct,67.0,63.4,11221201,10612285,608916,5.4,TC
10,2005,Nov,67.0,63.4,11227907,10621632,606275,5.4,TC
11,2005,Dec,67.0,63.4,11233098,10633045,600053,5.3,TC
12,2006,Jan,67.0,63.4,11240453,10647444,593009,5.3,TC
13,2006,Feb,67.0,63.4,11253367,10664814,588553,5.2,TC
14,2006,Mar,66.9,63.4,11272128,10683983,588145,5.2,TC
15,2006,Apr,66.8,63.3,11294298,10704340,589958,5.2,TC
16,2006,May,66.8,63.3,11316310,10726117,590193,5.2,TC
17,2006,Jun,66.7,63.2,11335374,10749064,586310,5.2,TC
18,2006,Jul,66.6,63.2,11351838,10775124,576714,5.1,TC
19,2006,Aug,66.6,63.3,11367207,10804130,563077,5.0,TC
20,2006,Sep,66.5,63.3,11381736,10832912,548824,4.8,TC
21,2006,Oct,66.5,63.3,11394861,10859232,535629,4.7,TC
22,2006,Nov,66.4,63.4,11405690,10881093,524597,4.6,TC
23,2006,Dec,66.3,63.3,11412317,10896648,515669,4.5,TC
24,2007,Jan,66.2,63.3,11413662,10905100,508562,4.5,TC
25,2007,Feb,66.1,63.2,11411958,10908743,503215,4.4,TC
26,2007,Mar,66.0,63.1,11408395,10909724,498671,4.4,TC
27,2007,Apr,65.9,63.0,11405711,10910668,495043,4.3,TC
28,2007,May,65.8,62.9,11406369,10913440,492929,4.3,TC
29,2007,Jun,65.7,62.9,11411196,10919419,491777,4.3,TC
30,2007,Jul,65.6,62.8,11421250,10928845,492405,4.3,TC
31,2007,Aug,65.6,62.8,11437858,10942199,495659,4.3,TC
32,2007,Sep,65.6,62.8,11459823,10960290,499533,4.4,TC
33,2007,Oct,65.6,62.8,11484031,10981282,502749,4.4,TC
34,2007,Nov,65.7,62.8,11508120,11004022,504098,4.4,TC
35,2007,Dec,65.7,62.8,11531148,11027674,503474,4.4,TC
36,2008,Jan,65.7,62.8,11551722,11049469,502253,4.3,TC
37,2008,Feb,65.7,62.9,11569544,11068110,501434,4.3,TC
38,2008,Mar,65.7,62.8,11587968,11084171,503797,4.3,TC
39,2008,Apr,65.7,62.8,11609646,11098012,511634,4.4,TC
40,2008,May,65.8,62.8,11635536,11109993,525543,4.5,TC
41,2008,Jun,65.8,62.8,11666163,11121171,544992,4.7,TC
42,2008,Jul,65.9,62.7,11698046,11131376,566670,4.8,TC
43,2008,Aug,65.9,62.6,11727305,11139202,588103,5.0,TC
44,2008,Sep,66.0,62.5,11751993,11141801,610192,5.2,TC
45,2008,Oct,66.0,62.4,11771507,11136874,634633,5.4,TC
46,2008,Nov,65.9,62.2,11784834,11123092,661742,5.6,TC
47,2008,Dec,65.9,62.0,11791925,11101977,689948,5.9,TC
48,2009,Jan,65.8,61.8,11794357,11077513,716844,6.1,TC
49,2009,Feb,65.7,61.5,11795821,11055073,740748,6.3,TC
50,2009,Mar,65.6,61.4,11799261,11040416,758845,6.4,TC
51,2009,Apr,65.5,61.2,11805364,11035746,769618,6.5,TC
52,2009,May,66.1,61.2,11933809,11037541,896268,7.5,TC
53,2009,Jun,66.4,61.1,11998393,11041350,957043,8.0,TC
54,2009,Jul,66.4,61.0,12027290,11042872,984418,8.2,TC
55,2009,Aug,66.4,60.9,12035941,11040880,995061,8.3,TC
56,2009,Sep,66.3,60.8,12036191,11038831,997360,8.3,TC
57,2009,Oct,66.2,60.7,12036269,11040270,995999,8.3,TC
58,2009,Nov,66.1,60.6,12045372,11050184,995188,8.3,TC
59,2009,Dec,66.1,60.7,12070223,11072620,997603,8.3,TC
60,2010,Jan,66.3,60.8,12108919,11106882,1002037,8.3,TC
61,2010,Feb,66.4,60.9,12151988,11146453,1005535,8.3,TC
62,2010,Mar,66.5,61.0,12191275,11184615,1006660,8.3,TC
63,2010,Apr,65.9,60.5,12222661,11218075,1004586,8.2,TC
64,2010,May,65.9,60.6,12244873,11246029,998844,8.2,TC
65,2010,Jun,65.9,60.6,12259778,11267141,992637,8.1,TC
66,2010,Jul,65.9,60.6,12272590,11282344,990246,8.1,TC
67,2010,Aug,65.9,60.6,12287949,11294712,993237,8.1,TC
68,2010,Sep,65.9,60.5,12306687,11306167,1000520,8.1,TC
69,2010,Oct,65.9,60.5,12329159,11320132,1009027,8.2,TC
70,2010,Nov,65.9,60.5,12352386,11337423,1014963,8.2,TC
71,2010,Dec,65.9,60.5,12372836,11356570,1016266,8.2,TC
72,2011,Jan,65.9,60.5,12391831,11377422,1014409,8.2,TC
73,2011,Feb,65.9,60.5,12409993,11398153,1011840,8.2,TC
74,2011,Mar,65.9,60.5,12426745,11416366,1010379,8.1,TC
75,2011,Apr,65.9,60.5,12444275,11431447,1012828,8.1,TC
76,2011,May,65.9,60.5,12467134,11445785,1021349,8.2,TC
77,2011,Jun,66.0,60.5,12497108,11463413,1033695,8.3,TC
78,2011,Jul,66.0,60.5,12534220,11487969,1046251,8.3,TC
79,2011,Aug,66.0,60.6,12546014,11519770,1026244,8.2,TC
80,2011,Sep,66.0,60.7,12559256,11556548,1002708,8.0,TC
81,2011,Oct,65.9,60.8,12570673,11594803,975870,7.8,TC
82,2011,Nov,65.8,60.9,12576962,11630243,946719,7.5,TC
83,2011,Dec,65.7,60.9,12576704,11659891,916813,7.3,TC
84,2012,Jan,65.6,61.0,12571937,11683759,888178,7.1,TC
85,2012,Feb,65.5,61.0,12581835,11704383,877452,7.0,TC
86,2012,Mar,65.4,61.0,12563758,11722322,841436,6.7,TC
87,2012,Apr,65.4,61.0,12588954,11737849,851105,6.8,TC
88,2012,May,65.4,61.0,12611625,11754758,856867,6.8,TC
89,2012,Jun,65.4,61.0,12632078,11776105,855973,6.8,TC
90,2012,Jul,65.4,61.0,12649825,11802014,847811,6.7,TC
91,2012,Aug,65.4,61.1,12666216,11830108,836108,6.6,TC
92,2012,Sep,65.4,61.1,12683588,11857386,826202,6.5,TC
93,2012,Oct,65.4,61.1,12700534,11879763,820771,6.5,TC
94,2012,Nov,65.3,61.1,12716045,11895325,820720,6.5,TC
95,2012,Dec,65.3,61.1,12730458,11905455,825003,6.5,TC
96,2013,Jan,65.3,61.0,12743658,11912520,831138,6.5,TC
97,2013,Feb,65.3,61.0,12757010,11921233,835777,6.6,TC
98,2013,Mar,65.2,61.0,12772688,11936855,835833,6.5,TC
99,2013,Apr,65.3,61.0,12793456,11962083,831373,6.5,TC
100,2013,May,65.3,61.1,12816378,11991479,824899,6.4,TC
101,2013,Jun,65.3,61.1,12837490,12018765,818725,6.4,TC
102,2013,Jul,65.3,61.1,12855277,12041788,813489,6.3,TC
103,2013,Aug,65.2,61.1,12867238,12061310,805928,6.3,TC
104,2013,Sep,65.1,61.1,12873858,12079341,794517,6.2,TC
105,2013,Oct,65.1,61.1,12880739,12099121,781618,6.1,TC
106,2013,Nov,65.0,61.1,12892128,12124031,768097,6.0,TC
107,2013,Dec,65.0,61.2,12907972,12154284,753688,5.8,TC
108,2014,Jan,65.0,61.2,12926206,12188294,737912,5.7,TC
109,2014,Feb,64.9,61.3,12944743,12223189,721554,5.6,TC
110,2014,Mar,64.9,61.4,12962485,12254958,707527,5.5,TC
111,2014,Apr,64.9,61.4,12977478,12280595,696883,5.4,TC
112,2014,May,64.9,61.4,12990622,12302615,688007,5.3,TC
113,2014,Jun,64.8,61.4,13005331,12325395,679936,5.2,TC
114,2014,Jul,64.8,61.4,13020533,12348864,671669,5.2,TC
115,2014,Aug,64.7,61.5,13036080,12373428,662652,5.1,TC
116,2014,Sep,64.7,61.5,13050337,12398563,651774,5.0,TC
117,2014,Oct,64.6,61.5,13058380,12420918,637462,4.9,TC
118,2014,Nov,64.5,61.4,13057664,12436708,620956,4.8,TC
119,2014,Dec,64.3,61.4,13051833,12446054,605779,4.6,TC
120,2015,Jan,64.2,61.3,13045727,12451402,594325,4.6,TC
121,2015,Feb,64.1,61.2,13042678,12455072,587606,4.5,TC
122,2015,Mar,64.0,61.1,13044962,12461125,583837,4.5,TC
123,2015,Apr,63.9,61.1,13052347,12471167,581180,4.5,TC
124,2015,May,63.9,61.0,13062363,12483045,579318,4.4,TC
125,2015,Jun,63.8,61.0,13072586,12493882,578704,4.4,TC
126,2015,Jul,63.7,60.9,13083798,12503348,580450,4.4,TC
127,2015,Aug,63.7,60.8,13096567,12512227,584340,4.5,TC
128,2015,Sep,63.7,60.8,13111812,12523886,587926,4.5,TC
129,2015,Oct,63.7,60.8,13133423,12543363,590060,4.5,TC
130,2015,Nov,63.7,60.8,13162283,12571333,590950,4.5,TC
131,2015,Dec,63.8,60.9,13194306,12603859,590447,4.5,TC
132,2016,Jan,63.8,61.0,13224910,12635778,589132,4.5,TC
133,2016,Feb,63.8,61.0,13252003,12662766,589237,4.4,TC
134,2016,Mar,63.8,61.0,13275533,12683175,592358,4.5,TC
135,2016,Apr,63.9,61.0,13297832,12698126,599706,4.5,TC
136,2016,May,63.9,60.9,13321031,12710616,610415,4.6,TC
137,2016,Jun,63.9,60.9,13344101,12722956,621145,4.7,TC
138,2016,Jul,63.9,60.9,13365941,12736496,629445,4.7,TC
139,2016,Aug,63.9,60.9,13386060,12750754,635306,4.7,TC
140,2016,Sep,63.9,60.8,13403980,12763563,640417,4.8,TC
141,2016,Oct,63.8,60.8,13419163,12774408,644755,4.8,TC
142,2016,Nov,63.8,60.8,13434311,12787312,646999,4.8,TC
143,2016,Dec,63.8,60.8,13452830,12805992,646838,4.8,TC
144,2017,Jan,63.8,60.7,13383543,12743129,640414,4.8,TC
145,2017,Feb,63.8,60.8,13407092,12773175,633917,4.7,TC
146,2017,Mar,63.8,60.9,13429146,12805899,623247,4.6,TC
147,2017,Apr,63.8,60.9,13448306,12838380,609926,4.5,TC
148,2017,May,63.8,61.0,13464024,12868903,595121,4.4,TC
149,2017,Jun,63.8,61.1,13476361,12894947,581414,4.3,TC
150,2017,Jul,63.8,61.1,13486545,12915730,570815,4.2,TC
151,2017,Aug,63.7,61.1,13495091,12931972,563119,4.2,TC
152,2017,Sep,63.7,61.1,13503616,12945812,557804,4.1,TC
153,2017,Oct,63.7,61.0,13513945,12959897,554048,4.1,TC
154,2017,Nov,63.6,61.0,13527004,12974970,552034,4.1,TC
155,2017,Dec,63.7,61.1,13545086,12994087,550999,4.1,TC
156,2018,Jan,63.7,61.1,13570502,13019810,550692,4.1,TC
157,2018,Feb,63.8,61.2,13603866,13053266,550600,4.0,TC
158,2018,Mar,63.9,61.3,13640180,13091083,549097,4.0,TC
159,2018,Apr,64.0,61.4,13670383,13125424,544959,4.0,TC
160,2018,May,64.0,61.5,13689632,13150005,539627,3.9,TC
161,2018,Jun,63.9,61.5,13698819,13164873,533946,3.9,TC
162,2018,Jul,63.9,61.4,13700824,13172521,528303,3.9,TC
163,2018,Aug,63.8,61.4,13702378,13177515,524863,3.8,TC
164,2018,Sep,63.7,61.3,13708279,13183494,524785,3.8,TC
165,2018,Oct,63.7,61.2,13719955,13193517,526438,3.8,TC
166,2018,Nov,63.7,61.2,13735166,13208364,526802,3.8,TC
167,2018,Dec,63.7,61.2,13750400,13227231,523169,3.8,TC
168,2019,Jan,63.7,61.3,13763201,13248657,514544,3.7,TC
169,2019,Feb,63.6,61.3,13774028,13272184,501844,3.6,TC
170,2019,Mar,63.6,61.4,13786042,13297251,488791,3.5,TC
171,2019,Apr,63.6,61.4,13803426,13324780,478646,3.5,TC
172,2019,May,63.6,61.5,13827325,13353151,474174,3.4,TC
173,2019,Jun,63.7,61.5,13856445,13379740,476705,3.4,TC
174,2019,Jul,63.8,61.5,13887034,13402466,484568,3.5,TC
175,2019,Aug,63.8,61.5,13914676,13421600,493076,3.5,TC
176,2019,Sep,63.8,61.5,13939282,13442538,496744,3.6,TC
177,2019,Oct,63.8,61.5,13961107,13465764,495343,3.5,TC
178,2019,Nov,63.8,61.6,13979205,13488900,490305,3.5,TC
179,2019,Dec,63.7,61.5,13985790,13501568,484222,3.5,TC
180,2020,Jan,63.6,61.4,13975565,13494841,480724,3.4,TC
181,2020,Feb,63.4,61.2,13949039,13466024,483015,3.5,TC
182,2020,Mar,62.8,59.6,13838344,13135701,702643,5.1,TC
183,2020,Apr,59.8,52.2,13190711,11522574,1668137,12.6,TC
184,2020,May,62.5,55.1,13800875,12172243,1628632,11.8,TC
185,2020,Jun,62.3,56.1,13777977,12393208,1384769,10.1,TC
186,2020,Jul,62.7,56.9,13888962,12601111,1287851,9.3,TC
187,2020,Aug,62.7,57.6,13889681,12769701,1119980,8.1,TC
188,2020,Sep,63.0,58.2,13983783,12909243,1074540,7.7,TC
189,2020,Oct,62.9,58.5,13988179,13001357,986822,7.1,TC
190,2020,Nov,63.1,58.7,14034827,13060347,974480,6.9,TC
191,2020,Dec,63.2,58.8,14077183,13099439,977744,6.9,TC
192,2021,Jan,63.2,58.9,14084103,13135663,948440,6.7,TC
193,2021,Feb,63.2,59.0,14108447,13178764,929683,6.6,TC
194,2021,Mar,63.3,59.2,14137958,13233703,904255,6.4,TC
195,2021,Apr,63.3,59.4,14170095,13294137,875958,6.2,TC
196,2021,May,63.4,59.6,14194328,13353800,840528,5.9,TC
197,2021,Jun,63.5,59.8,14243426,13405578,837848,5.9,TC
198,2021,Jul,63.4,59.9,14249596,13455074,794522,5.6,TC
199,2021,Aug,63.4,60.0,14269081,13500355,768726,5.4,TC
200,2021,Sep,63.3,60.1,14272899,13544229,728670,5.1,TC
201,2021,Oct,63.3,60.2,14295547,13581395,714152,5.0,TC
202,2021,Nov,63.2,60.1,14287946,13593060,694886,4.9,TC
203,2021,Dec,63.1,60.1,14282879,13595276,687603,4.8,TC
204,2022,Jan,63.3,60.2,14333539,13645548,687991,4.8,TC
205,2022,Feb,63.4,60.4,14373632,13698584,675048,4.7,TC
206,2022,Mar,63.4,60.7,14414296,13779753,634543,4.4,TC
207,2022,Apr,63.6,60.8,14459425,13838703,620722,4.3,TC
208,2022,May,63.7,61.1,14515783,13907819,607964,4.2,TC
209,2022,Jun,63.8,61.2,14555411,13957671,597740,4.1,TC
210,2022,Jul,63.8,61.3,14584437,13995232,589205,4.0,TC
211,2022,Aug,63.8,61.2,14595814,14001230,594584,4.1,TC
212,2022,Sep,63.6,61.1,14583680,14003077,580603,4.0,TC
213,2022,Oct,63.6,61.0,14592133,14002866,589267,4.0,TC
214,2022,Nov,63.5,61.0,14594428,14015544,578884,4.0,TC
0,2005,Jan,66.6,62.3,5859119,5488022,371097,6.3,OH
1,2005,Feb,66.6,62.4,5861578,5493034,368544,6.3,OH
2,2005,Mar,66.6,62.5,5864576,5500803,363773,6.2,OH
3,2005,Apr,66.6,62.6,5868991,5511573,357418,6.1,OH
4,2005,May,66.7,62.7,5874671,5524226,350445,6.0,OH
5,2005,Jun,66.7,62.8,5880174,5536130,344044,5.9,OH
6,2005,Jul,66.7,62.9,5885049,5544880,340169,5.8,OH
7,2005,Aug,66.8,62.9,5889390,5550220,339170,5.8,OH
8,2005,Sep,66.8,62.9,5893220,5553817,339403,5.8,OH
9,2005,Oct,66.7,62.9,5896020,5557780,338240,5.7,OH
10,2005,Nov,66.7,62.9,5897939,5562941,334998,5.7,OH
11,2005,Dec,66.7,63.0,5898850,5568986,329864,5.6,OH
12,2006,Jan,66.7,63.1,5900385,5577335,323050,5.5,OH
13,2006,Feb,66.7,63.2,5904768,5588283,316485,5.4,OH
14,2006,Mar,66.8,63.3,5912662,5599950,312712,5.3,OH
15,2006,Apr,66.9,63.4,5923616,5610899,312717,5.3,OH
16,2006,May,67.1,63.5,5936851,5621439,315412,5.3,OH
17,2006,Jun,67.2,63.6,5950887,5631674,319213,5.4,OH
18,2006,Jul,67.3,63.7,5964470,5641744,322726,5.4,OH
19,2006,Aug,67.5,63.8,5978031,5652208,325823,5.5,OH
20,2006,Sep,67.6,63.9,5990760,5662364,328396,5.5,OH
21,2006,Oct,67.6,63.9,6001365,5672001,329364,5.5,OH
22,2006,Nov,67.7,64.0,6008981,5680298,328683,5.5,OH
23,2006,Dec,67.7,64.0,6013359,5686100,327259,5.4,OH
24,2007,Jan,67.7,64.0,6015798,5688698,327100,5.4,OH
25,2007,Feb,67.7,64.0,6017630,5689064,328566,5.5,OH
26,2007,Mar,67.7,64.0,6018863,5688428,330435,5.5,OH
27,2007,Apr,67.7,64.0,6019476,5686963,332513,5.5,OH
28,2007,May,67.7,63.9,6019240,5683902,335338,5.6,OH
29,2007,Jun,67.6,63.8,6018239,5679913,338326,5.6,OH
30,2007,Jul,67.6,63.8,6016911,5676080,340831,5.7,OH
31,2007,Aug,67.6,63.7,6015646,5672744,342902,5.7,OH
32,2007,Sep,67.5,63.7,6015396,5671388,344008,5.7,OH
33,2007,Oct,67.5,63.6,6016279,5671830,344449,5.7,OH
34,2007,Nov,67.5,63.6,6016931,5673416,343515,5.7,OH
35,2007,Dec,67.5,63.7,6016753,5675653,341100,5.7,OH
36,2008,Jan,67.4,63.6,6014754,5675960,338794,5.6,OH
37,2008,Feb,67.4,63.6,6011252,5672357,338895,5.6,OH
38,2008,Mar,67.4,63.5,6008457,5664400,344057,5.7,OH
39,2008,Apr,67.3,63.4,6007620,5652710,354910,5.9,OH
40,2008,May,67.3,63.2,6009324,5639316,370008,6.2,OH
41,2008,Jun,67.3,63.0,6012507,5625793,386714,6.4,OH
42,2008,Jul,67.3,62.8,6014218,5612464,401754,6.7,OH
43,2008,Aug,67.3,62.7,6011816,5598120,413696,6.9,OH
44,2008,Sep,67.2,62.4,6004979,5579973,425006,7.1,OH
45,2008,Oct,67.1,62.2,5995207,5556150,439057,7.3,OH
46,2008,Nov,66.9,61.8,5983594,5525376,458218,7.7,OH
47,2008,Dec,66.8,61.4,5970422,5487378,483044,8.1,OH
48,2009,Jan,66.6,60.9,5956344,5444780,511564,8.6,OH
49,2009,Feb,66.4,60.4,5942920,5402230,540690,9.1,OH
50,2009,Mar,66.3,60.0,5931002,5364822,566180,9.5,OH
51,2009,Apr,66.2,59.6,5920506,5335602,584904,9.9,OH
52,2009,May,66.0,59.4,5910747,5313941,596806,10.1,OH
53,2009,Jun,65.9,59.2,5902027,5297717,604310,10.2,OH
54,2009,Jul,65.8,59.0,5894470,5283917,610553,10.4,OH
55,2009,Aug,65.7,58.8,5888132,5270650,617482,10.5,OH
56,2009,Sep,65.7,58.7,5883486,5257988,625498,10.6,OH
57,2009,Oct,65.6,58.5,5880324,5245920,634404,10.8,OH
58,2009,Nov,65.6,58.4,5880807,5236980,643827,10.9,OH
59,2009,Dec,65.7,58.4,5886389,5234320,652069,11.1,OH
60,2010,Jan,65.7,58.4,5895027,5238928,656099,11.1,OH
61,2010,Feb,65.8,58.5,5902220,5248612,653608,11.1,OH
62,2010,Mar,65.8,58.6,5904597,5259913,644684,10.9,OH
63,2010,Apr,65.9,58.8,5901230,5269891,631339,10.7,OH
64,2010,May,65.8,58.9,5892307,5276565,615742,10.4,OH
65,2010,Jun,65.6,58.9,5879456,5278705,600751,10.2,OH
66,2010,Jul,65.4,58.8,5866162,5277025,589137,10.0,OH
67,2010,Aug,65.3,58.8,5855186,5273622,581564,9.9,OH
68,2010,Sep,65.1,58.7,5846806,5270258,576548,9.9,OH
69,2010,Oct,65.0,58.7,5840618,5269337,571281,9.8,OH
70,2010,Nov,65.0,58.7,5834361,5271037,563324,9.7,OH
71,2010,Dec,64.9,58.7,5826065,5273672,552393,9.5,OH
72,2011,Jan,64.7,58.7,5816035,5275424,540611,9.3,OH
73,2011,Feb,64.6,58.7,5804853,5274342,530511,9.1,OH
74,2011,Mar,64.5,58.6,5793724,5270128,523596,9.0,OH
75,2011,Apr,64.3,58.6,5784616,5264185,520431,9.0,OH
76,2011,May,64.3,58.5,5778681,5258057,520624,9.0,OH
77,2011,Jun,64.2,58.4,5774881,5253336,521545,9.0,OH
78,2011,Jul,64.1,58.4,5771503,5251468,520035,9.0,OH
79,2011,Aug,64.1,58.4,5767102,5252818,514284,8.9,OH
80,2011,Sep,64.0,58.4,5760793,5256975,503818,8.7,OH
81,2011,Oct,63.9,58.4,5753316,5263328,489988,8.5,OH
82,2011,Nov,63.8,58.5,5745836,5270678,475158,8.3,OH
83,2011,Dec,63.7,58.6,5739218,5277947,461271,8.0,OH
84,2012,Jan,63.6,58.6,5734275,5284949,449326,7.8,OH
85,2012,Feb,63.6,58.7,5731180,5291278,439902,7.7,OH
86,2012,Mar,63.5,58.7,5727867,5294585,433282,7.6,OH
87,2012,Apr,63.5,58.7,5721910,5293517,428393,7.5,OH
88,2012,May,63.4,58.7,5714684,5290887,423797,7.4,OH
89,2012,Jun,63.3,58.6,5708474,5289595,418879,7.3,OH
90,2012,Jul,63.2,58.6,5703982,5290271,413711,7.3,OH
91,2012,Aug,63.2,58.6,5701818,5292044,409774,7.2,OH
92,2012,Sep,63.1,58.6,5702365,5293329,409036,7.2,OH
93,2012,Oct,63.1,58.6,5703549,5291979,411570,7.2,OH
94,2012,Nov,63.1,58.5,5703304,5287084,416220,7.3,OH
95,2012,Dec,63.1,58.4,5701489,5279998,421491,7.4,OH
96,2013,Jan,63.0,58.3,5699301,5272736,426565,7.5,OH
97,2013,Feb,63.0,58.2,5698685,5268265,430420,7.6,OH
98,2013,Mar,63.0,58.2,5701127,5269020,432107,7.6,OH
99,2013,Apr,63.1,58.3,5706929,5274989,431940,7.6,OH
100,2013,May,63.1,58.3,5713147,5281766,431381,7.6,OH
101,2013,Jun,63.1,58.4,5717334,5285529,431805,7.6,OH
102,2013,Jul,63.1,58.3,5718793,5285992,432801,7.6,OH
103,2013,Aug,63.1,58.3,5716629,5284908,431721,7.6,OH
104,2013,Sep,63.0,58.3,5711245,5284794,426451,7.5,OH
105,2013,Oct,62.9,58.3,5705087,5287632,417455,7.3,OH
106,2013,Nov,62.8,58.3,5700211,5294623,405588,7.1,OH
107,2013,Dec,62.7,58.4,5696553,5304884,391669,6.9,OH
108,2014,Jan,62.7,58.5,5693500,5316915,376585,6.6,OH
109,2014,Feb,62.7,58.7,5691029,5328838,362191,6.4,OH
110,2014,Mar,62.6,58.8,5690228,5339396,350832,6.2,OH
111,2014,Apr,62.6,58.9,5691744,5348627,343117,6.0,OH
112,2014,May,62.7,58.9,5696376,5358794,337582,5.9,OH
113,2014,Jun,62.7,59.1,5704592,5372122,332470,5.8,OH
114,2014,Jul,62.8,59.2,5714956,5387836,327120,5.7,OH
115,2014,Aug,62.9,59.4,5726029,5404261,321768,5.6,OH
116,2014,Sep,63.0,59.5,5735306,5419107,316199,5.5,OH
117,2014,Oct,63.0,59.6,5740022,5429896,310126,5.4,OH
118,2014,Nov,63.0,59.6,5738510,5434432,304078,5.3,OH
119,2014,Dec,62.9,59.6,5732637,5433117,299520,5.2,OH
120,2015,Jan,62.8,59.5,5725314,5428302,297012,5.2,OH
121,2015,Feb,62.7,59.5,5719068,5423145,295923,5.2,OH
122,2015,Mar,62.7,59.5,5715533,5421129,294404,5.2,OH
123,2015,Apr,62.7,59.5,5713945,5422656,291289,5.1,OH
124,2015,May,62.6,59.5,5712467,5426068,286399,5.0,OH
125,2015,Jun,62.6,59.5,5709322,5428877,280445,4.9,OH
126,2015,Jul,62.5,59.5,5704862,5429949,274913,4.8,OH
127,2015,Aug,62.4,59.5,5700670,5429438,271232,4.8,OH
128,2015,Sep,62.4,59.4,5698995,5428901,270094,4.7,OH
129,2015,Oct,62.4,59.4,5702644,5430886,271758,4.8,OH
130,2015,Nov,62.5,59.5,5713128,5437112,276016,4.8,OH
131,2015,Dec,62.7,59.6,5728436,5446975,281461,4.9,OH
132,2016,Jan,62.8,59.7,5743731,5457717,286014,5.0,OH
133,2016,Feb,62.9,59.8,5754850,5466498,288352,5.0,OH
134,2016,Mar,63.0,59.8,5759537,5471393,288144,5.0,OH
135,2016,Apr,62.9,59.8,5759108,5472521,286587,5.0,OH
136,2016,May,62.9,59.8,5756166,5470836,285330,5.0,OH
137,2016,Jun,62.8,59.7,5752564,5467270,285294,5.0,OH
138,2016,Jul,62.8,59.7,5749748,5463246,286502,5.0,OH
139,2016,Aug,62.7,59.6,5749164,5459942,289222,5.0,OH
140,2016,Sep,62.8,59.5,5752040,5458133,293907,5.1,OH
141,2016,Oct,62.8,59.5,5757428,5457993,299435,5.2,OH
142,2016,Nov,62.8,59.5,5763754,5460359,303395,5.3,OH
143,2016,Dec,62.9,59.6,5770112,5465690,304422,5.3,OH
144,2017,Jan,62.9,59.6,5795256,5490665,304591,5.3,OH
145,2017,Feb,62.9,59.7,5803585,5501760,301825,5.2,OH
146,2017,Mar,63.0,59.8,5811518,5512940,298578,5.1,OH
147,2017,Apr,63.1,59.9,5818553,5523019,295534,5.1,OH
148,2017,May,63.1,59.9,5824602,5531724,292878,5.0,OH
149,2017,Jun,63.1,60.0,5829922,5538880,291042,5.0,OH
150,2017,Jul,63.2,60.0,5834261,5544228,290033,5.0,OH
151,2017,Aug,63.1,60.0,5834899,5546538,288361,4.9,OH
152,2017,Sep,63.1,60.0,5829698,5545045,284653,4.9,OH
153,2017,Oct,62.9,59.9,5819720,5540955,278765,4.8,OH
154,2017,Nov,62.8,59.8,5807581,5535041,272540,4.7,OH
155,2017,Dec,62.6,59.8,5797032,5529682,267350,4.6,OH
156,2018,Jan,62.6,59.7,5792326,5527995,264331,4.6,OH
157,2018,Feb,62.6,59.8,5795561,5531967,263594,4.5,OH
158,2018,Mar,62.7,59.9,5804690,5540584,264106,4.5,OH
159,2018,Apr,62.8,59.9,5814581,5550258,264323,4.5,OH
160,2018,May,62.9,60.0,5821048,5557458,263590,4.5,OH
161,2018,Jun,62.8,60.0,5822385,5560741,261644,4.5,OH
162,2018,Jul,62.8,60.0,5819475,5560160,259315,4.5,OH
163,2018,Aug,62.7,60.0,5817007,5558675,258332,4.4,OH
164,2018,Sep,62.7,59.9,5818289,5558863,259426,4.5,OH
165,2018,Oct,62.8,59.9,5823126,5561626,261500,4.5,OH
166,2018,Nov,62.8,60.0,5829597,5567040,262557,4.5,OH
167,2018,Dec,62.9,60.0,5835554,5574895,260659,4.5,OH
168,2019,Jan,62.9,60.1,5839215,5584312,254903,4.4,OH
169,2019,Feb,62.9,60.3,5841425,5595322,246103,4.2,OH
170,2019,Mar,62.9,60.4,5844984,5607429,237555,4.1,OH
171,2019,Apr,63.0,60.5,5851580,5619380,232200,4.0,OH
172,2019,May,63.1,60.6,5860300,5628868,231432,3.9,OH
173,2019,Jun,63.1,60.6,5869614,5634675,234939,4.0,OH
174,2019,Jul,63.2,60.6,5877713,5636741,240972,4.1,OH
175,2019,Aug,63.2,60.6,5883368,5636161,247207,4.2,OH
176,2019,Sep,63.3,60.6,5888347,5636766,251581,4.3,OH
177,2019,Oct,63.3,60.6,5895472,5641013,254459,4.3,OH
178,2019,Nov,63.4,60.7,5905527,5649133,256394,4.3,OH
179,2019,Dec,63.5,60.7,5914143,5654755,259388,4.4,OH
180,2020,Jan,63.5,60.7,5915607,5650552,265055,4.5,OH
181,2020,Feb,63.4,60.5,5906128,5633460,272668,4.6,OH
182,2020,Mar,62.5,59.5,5820521,5541056,279465,4.8,OH
183,2020,Apr,59.4,49.7,5534881,4626775,908106,16.4,OH
184,2020,May,60.7,52.9,5650297,4931906,718391,12.7,OH
185,2020,Jun,60.7,54.1,5657020,5034211,622809,11.0,OH
186,2020,Jul,61.2,55.1,5697795,5135618,562177,9.9,OH
187,2020,Aug,61.2,56.0,5698513,5218792,479721,8.4,OH
188,2020,Sep,61.5,56.8,5726145,5289202,436943,7.6,OH
189,2020,Oct,61.4,57.2,5724911,5333474,391437,6.8,OH
190,2020,Nov,61.5,57.5,5727393,5357664,369729,6.5,OH
191,2020,Dec,61.4,57.6,5724862,5367917,356945,6.2,OH
192,2021,Jan,61.3,57.7,5714401,5373635,340766,6.0,OH
193,2021,Feb,61.3,57.8,5714426,5381284,333142,5.8,OH
194,2021,Mar,61.4,57.9,5721886,5395357,326529,5.7,OH
195,2021,Apr,61.6,58.1,5735462,5414477,320985,5.6,OH
196,2021,May,61.7,58.3,5746415,5434215,312200,5.4,OH
197,2021,Jun,61.7,58.5,5754438,5448991,305447,5.3,OH
198,2021,Jul,61.7,58.6,5753858,5459218,294640,5.1,OH
199,2021,Aug,61.6,58.6,5748929,5465945,282984,4.9,OH
200,2021,Sep,61.5,58.7,5742109,5471719,270390,4.7,OH
201,2021,Oct,61.5,58.7,5739102,5478409,260693,4.5,OH
202,2021,Nov,61.5,58.7,5739444,5482593,256851,4.5,OH
203,2021,Dec,61.5,58.7,5741266,5485438,255828,4.5,OH
204,2022,Jan,61.5,58.9,5743974,5497756,246218,4.3,OH
205,2022,Feb,61.6,59.0,5749599,5507821,241778,4.2,OH
206,2022,Mar,61.7,59.1,5763350,5526585,236765,4.1,OH
207,2022,Apr,61.8,59.3,5773484,5540550,232934,4.0,OH
208,2022,May,62.0,59.5,5791977,5565690,226287,3.9,OH
209,2022,Jun,62.0,59.6,5794721,5570713,224008,3.9,OH
210,2022,Jul,61.9,59.6,5794695,5571213,223482,3.9,OH
211,2022,Aug,61.8,59.4,5787036,5558087,228949,4.0,OH
212,2022,Sep,61.7,59.2,5777872,5545949,231923,4.0,OH
213,2022,Oct,61.5,58.9,5761005,5519414,241591,4.2,OH
214,2022,Nov,61.3,58.7,5743856,5500637,243219,4.2,OH
0,2005,Jan,61.8,59.7,8492386,8206242,286144,3.4,FL
1,2005,Feb,61.9,59.8,8519788,8240124,279664,3.3,FL
2,2005,Mar,62.0,60.0,8548127,8276228,271899,3.2,FL
3,2005,Apr,62.1,60.2,8579298,8316002,263296,3.1,FL
4,2005,May,62.2,60.3,8613694,8359329,254365,3.0,FL
5,2005,Jun,62.3,60.5,8648158,8402146,246012,2.8,FL
6,2005,Jul,62.4,60.7,8679055,8440004,239051,2.8,FL
7,2005,Aug,62.5,60.8,8704254,8470906,233348,2.7,FL
8,2005,Sep,62.5,60.9,8723602,8495124,228478,2.6,FL
9,2005,Oct,62.4,60.8,8739398,8515544,223854,2.6,FL
10,2005,Nov,62.4,60.9,8754532,8534968,219564,2.5,FL
11,2005,Dec,62.4,60.9,8770521,8554725,215796,2.5,FL
12,2006,Jan,62.5,61.0,8789465,8576664,212801,2.4,FL
13,2006,Feb,62.6,61.1,8812184,8601209,210975,2.4,FL
14,2006,Mar,62.7,61.2,8837309,8626543,210766,2.4,FL
15,2006,Apr,62.8,61.3,8863169,8650938,212231,2.4,FL
16,2006,May,62.9,61.4,8888754,8674278,214476,2.4,FL
17,2006,Jun,63.0,61.4,8913367,8696519,216848,2.4,FL
18,2006,Jul,63.0,61.5,8938216,8719152,219064,2.5,FL
19,2006,Aug,63.2,61.6,8964208,8742603,221605,2.5,FL
20,2006,Sep,63.3,61.7,8990679,8765814,224865,2.5,FL
21,2006,Oct,63.4,61.8,9016846,8788180,228666,2.5,FL
22,2006,Nov,63.5,61.9,9041667,8808471,233196,2.6,FL
23,2006,Dec,63.6,61.9,9063204,8824665,238539,2.6,FL
24,2007,Jan,63.6,61.9,9079865,8835015,244850,2.7,FL
25,2007,Feb,63.7,61.9,9091891,8839714,252177,2.8,FL
26,2007,Mar,63.7,61.8,9099437,8839277,260160,2.9,FL
27,2007,Apr,63.6,61.8,9103305,8834580,268725,3.0,FL
28,2007,May,63.6,61.6,9104735,8826525,278210,3.1,FL
29,2007,Jun,63.5,61.5,9105560,8817098,288462,3.2,FL
30,2007,Jul,63.5,61.4,9107665,8808067,299598,3.3,FL
31,2007,Aug,63.5,61.3,9113142,8801072,312070,3.4,FL
32,2007,Sep,63.5,61.2,9122980,8797471,325509,3.6,FL
33,2007,Oct,63.5,61.1,9135500,8795668,339832,3.7,FL
34,2007,Nov,63.5,61.1,9148193,8793740,354453,3.9,FL
35,2007,Dec,63.6,61.0,9159259,8789788,369471,4.0,FL
36,2008,Jan,63.6,60.9,9166494,8780743,385751,4.2,FL
37,2008,Feb,63.5,60.7,9169252,8765562,403690,4.4,FL
38,2008,Mar,63.5,60.6,9169367,8745057,424310,4.6,FL
39,2008,Apr,63.5,60.4,9168749,8720582,448167,4.9,FL
40,2008,May,63.4,60.1,9169161,8694289,474872,5.2,FL
41,2008,Jun,63.4,59.9,9171233,8667892,503341,5.5,FL
42,2008,Jul,63.3,59.7,9172784,8640817,531967,5.8,FL
43,2008,Aug,63.3,59.4,9170735,8610848,559887,6.1,FL
44,2008,Sep,63.2,59.1,9162508,8574307,588201,6.4,FL
45,2008,Oct,63.0,58.8,9143874,8528323,615551,6.7,FL
46,2008,Nov,62.8,58.3,9117676,8472472,645204,7.1,FL
47,2008,Dec,62.5,57.9,9086029,8409554,676475,7.4,FL
48,2009,Jan,62.3,57.4,9052178,8343928,708250,7.8,FL
49,2009,Feb,62.0,56.9,9020030,8280792,739238,8.2,FL
50,2009,Mar,61.8,56.5,8993087,8226093,766994,8.5,FL
51,2009,Apr,61.6,56.2,8974062,8182726,791336,8.8,FL
52,2009,May,61.7,55.9,8990744,8148166,842578,9.4,FL
53,2009,Jun,61.7,55.7,8991320,8119224,872096,9.7,FL
54,2009,Jul,61.6,55.5,8985929,8092905,893024,9.9,FL
55,2009,Aug,61.5,55.3,8978345,8067438,910907,10.1,FL
56,2009,Sep,61.4,55.0,8971805,8044442,927363,10.3,FL
57,2009,Oct,61.3,54.9,8968645,8026138,942507,10.5,FL
58,2009,Nov,61.3,54.7,8973003,8016095,956908,10.7,FL
59,2009,Dec,61.3,54.7,8987807,8017476,970331,10.8,FL
60,2010,Jan,61.4,54.7,9011633,8031055,980578,10.9,FL
61,2010,Feb,61.6,54.9,9039135,8052755,986380,10.9,FL
62,2010,Mar,61.7,55.0,9065533,8076970,988563,10.9,FL
63,2010,Apr,60.8,54.2,9099777,8111208,988569,10.9,FL
64,2010,May,61.0,54.4,9128507,8141742,986765,10.8,FL
65,2010,Jun,61.1,54.5,9150806,8165455,985351,10.8,FL
66,2010,Jul,61.1,54.5,9169009,8181978,987031,10.8,FL
67,2010,Aug,61.1,54.5,9186214,8194731,991483,10.8,FL
68,2010,Sep,61.2,54.6,9203325,8206908,996417,10.8,FL
69,2010,Oct,61.2,54.5,9215892,8216792,999100,10.8,FL
70,2010,Nov,61.3,54.6,9239476,8241889,997587,10.8,FL
71,2010,Dec,61.2,54.7,9245364,8253492,991872,10.7,FL
72,2011,Jan,61.2,54.7,9251721,8267299,984422,10.6,FL
73,2011,Feb,61.1,54.7,9252149,8280635,971514,10.5,FL
74,2011,Mar,61.1,54.7,9250847,8290918,959929,10.4,FL
75,2011,Apr,61.0,54.7,9247888,8297312,950576,10.3,FL
76,2011,May,60.9,54.7,9246195,8302264,943931,10.2,FL
77,2011,Jun,60.9,54.7,9247380,8309731,937649,10.1,FL
78,2011,Jul,60.8,54.7,9251715,8322847,928868,10.0,FL
79,2011,Aug,60.8,54.8,9261107,8341528,919579,9.9,FL
80,2011,Sep,60.7,54.8,9265057,8363923,901134,9.7,FL
81,2011,Oct,60.7,54.9,9276833,8387525,889308,9.6,FL
82,2011,Nov,60.7,55.0,9285382,8409108,876274,9.4,FL
83,2011,Dec,60.7,55.0,9289835,8426736,863099,9.3,FL
84,2012,Jan,60.6,55.0,9292160,8441097,851063,9.2,FL
85,2012,Feb,60.6,55.1,9296328,8454837,841491,9.1,FL
86,2012,Mar,60.5,55.1,9303773,8468399,835374,9.0,FL
87,2012,Apr,60.5,55.1,9312582,8481558,831024,8.9,FL
88,2012,May,60.5,55.1,9322199,8496177,826022,8.9,FL
89,2012,Jun,60.5,55.2,9332286,8513758,818528,8.8,FL
90,2012,Jul,60.5,55.3,9342026,8534305,807721,8.6,FL
91,2012,Aug,60.5,55.3,9352027,8556664,795363,8.5,FL
92,2012,Sep,60.5,55.4,9363037,8578931,784106,8.4,FL
93,2012,Oct,60.4,55.4,9372631,8597972,774659,8.3,FL
94,2012,Nov,60.4,55.5,9379264,8612023,767241,8.2,FL
95,2012,Dec,60.3,55.5,9382701,8621568,761133,8.1,FL
96,2013,Jan,60.3,55.4,9383321,8628007,755314,8.0,FL
97,2013,Feb,60.2,55.4,9383328,8634844,748484,8.0,FL
98,2013,Mar,60.2,55.4,9385906,8646346,739560,7.9,FL
99,2013,Apr,60.2,55.5,9394008,8664776,729232,7.8,FL
100,2013,May,60.2,55.6,9405649,8686257,719392,7.6,FL
101,2013,Jun,60.2,55.6,9417639,8706200,711439,7.6,FL
102,2013,Jul,60.1,55.6,9427528,8722512,705016,7.5,FL
103,2013,Aug,60.1,55.6,9432470,8735091,697379,7.4,FL
104,2013,Sep,60.0,55.6,9433614,8746255,687359,7.3,FL
105,2013,Oct,59.9,55.6,9436839,8759566,677273,7.2,FL
106,2013,Nov,59.9,55.7,9446215,8777668,668547,7.1,FL
107,2013,Dec,59.9,55.7,9461489,8800149,661340,7.0,FL
108,2014,Jan,59.9,55.8,9479786,8825090,654696,6.9,FL
109,2014,Feb,60.0,55.9,9497821,8849988,647833,6.8,FL
110,2014,Mar,60.0,55.9,9513557,8872130,641427,6.7,FL
111,2014,Apr,60.0,56.0,9525298,8890013,635285,6.7,FL
112,2014,May,59.9,56.0,9534040,8905898,628142,6.6,FL
113,2014,Jun,59.9,56.0,9543064,8923099,619965,6.5,FL
114,2014,Jul,59.9,56.1,9553381,8941700,611681,6.4,FL
115,2014,Aug,59.9,56.1,9565595,8961454,604141,6.3,FL
116,2014,Sep,59.8,56.1,9577872,8980727,597145,6.2,FL
117,2014,Oct,59.8,56.1,9586098,8996931,589167,6.1,FL
118,2014,Nov,59.7,56.1,9588482,9008617,579865,6.0,FL
119,2014,Dec,59.6,56.0,9588236,9017099,571137,6.0,FL
120,2015,Jan,59.5,56.0,9588873,9024705,564168,5.9,FL
121,2015,Feb,59.4,56.0,9592040,9032822,559218,5.8,FL
122,2015,Mar,59.4,55.9,9598497,9043681,554816,5.8,FL
123,2015,Apr,59.3,55.9,9607811,9058084,549727,5.7,FL
124,2015,May,59.3,56.0,9618147,9074570,543577,5.7,FL
125,2015,Jun,59.3,56.0,9627791,9091449,536342,5.6,FL
126,2015,Jul,59.2,56.0,9637406,9108581,528825,5.5,FL
127,2015,Aug,59.2,56.0,9648341,9126443,521898,5.4,FL
128,2015,Sep,59.1,56.0,9661738,9146394,515344,5.3,FL
129,2015,Oct,59.1,56.0,9679856,9170460,509396,5.3,FL
130,2015,Nov,59.2,56.1,9702643,9198031,504612,5.2,FL
131,2015,Dec,59.2,56.2,9726210,9226214,499996,5.1,FL
132,2016,Jan,59.2,56.2,9746916,9252093,494823,5.1,FL
133,2016,Feb,59.2,56.3,9763853,9274276,489577,5.0,FL
134,2016,Mar,59.2,56.3,9777290,9292824,484466,5.0,FL
135,2016,Apr,59.2,56.3,9790156,9309537,480619,4.9,FL
136,2016,May,59.2,56.3,9806455,9327449,479006,4.9,FL
137,2016,Jun,59.2,56.3,9826989,9347749,479240,4.9,FL
138,2016,Jul,59.2,56.3,9850017,9369741,480276,4.9,FL
139,2016,Aug,59.3,56.4,9873290,9391728,481562,4.9,FL
140,2016,Sep,59.3,56.4,9894617,9411626,482991,4.9,FL
141,2016,Oct,59.3,56.4,9912032,9428996,483036,4.9,FL
142,2016,Nov,59.3,56.4,9926694,9446908,479786,4.8,FL
143,2016,Dec,59.3,56.5,9941833,9468761,473072,4.8,FL
144,2017,Jan,59.3,56.5,9895826,9432161,463665,4.7,FL
145,2017,Feb,59.3,56.6,9918105,9463848,454257,4.6,FL
146,2017,Mar,59.4,56.7,9942750,9497565,445185,4.5,FL
147,2017,Apr,59.5,56.9,9965664,9528286,437378,4.4,FL
148,2017,May,59.5,56.9,9982016,9551303,430713,4.3,FL
149,2017,Jun,59.4,56.9,9990313,9564671,425642,4.3,FL
150,2017,Jul,59.4,56.9,9992489,9570284,422205,4.2,FL
151,2017,Aug,59.3,56.8,9991052,9571788,419264,4.2,FL
152,2017,Sep,59.2,56.7,9989384,9573364,416020,4.2,FL
153,2017,Oct,59.1,56.7,9991165,9578823,412342,4.1,FL
154,2017,Nov,59.1,56.7,9997632,9589039,408593,4.1,FL
155,2017,Dec,59.1,56.7,10009156,9604892,404264,4.0,FL
156,2018,Jan,59.1,56.8,10025901,9626354,399547,4.0,FL
157,2018,Feb,59.2,56.9,10047195,9652344,394851,3.9,FL
158,2018,Mar,59.3,57.0,10069727,9679693,390034,3.9,FL
159,2018,Apr,59.3,57.1,10089728,9705256,384472,3.8,FL
160,2018,May,59.3,57.1,10105273,9726952,378321,3.7,FL
161,2018,Jun,59.3,57.1,10115702,9743983,371719,3.7,FL
162,2018,Jul,59.3,57.2,10121611,9756396,365215,3.6,FL
163,2018,Aug,59.3,57.1,10126261,9765658,360603,3.6,FL
164,2018,Sep,59.2,57.1,10131789,9773009,358780,3.5,FL
165,2018,Oct,59.2,57.1,10138858,9779580,359278,3.5,FL
166,2018,Nov,59.2,57.1,10146721,9786049,360672,3.6,FL
167,2018,Dec,59.2,57.1,10154996,9793706,361290,3.6,FL
168,2019,Jan,59.2,57.1,10163853,9804134,359719,3.5,FL
169,2019,Feb,59.2,57.1,10174296,9819178,355118,3.5,FL
170,2019,Mar,59.2,57.2,10188506,9839536,348970,3.4,FL
171,2019,Apr,59.3,57.3,10208164,9865230,342934,3.4,FL
172,2019,May,59.3,57.4,10232098,9893904,338194,3.3,FL
173,2019,Jun,59.4,57.5,10257501,9922572,334929,3.3,FL
174,2019,Jul,59.5,57.6,10280729,9948509,332220,3.2,FL
175,2019,Aug,59.5,57.6,10299370,9971189,328181,3.2,FL
176,2019,Sep,59.6,57.7,10315348,9994122,321226,3.1,FL
177,2019,Oct,59.6,57.8,10329967,10017597,312370,3.0,FL
178,2019,Nov,59.6,57.8,10342567,10039400,303167,2.9,FL
179,2019,Dec,59.5,57.8,10345433,10050398,295035,2.9,FL
180,2020,Jan,59.4,57.7,10330438,10042297,288141,2.8,FL
181,2020,Feb,59.1,57.5,10294450,10012525,281925,2.7,FL
182,2020,Mar,58.7,56.1,10227585,9771252,456333,4.5,FL
183,2020,Apr,53.8,46.7,9380853,8143705,1237148,13.2,FL
184,2020,May,57.5,49.5,10037789,8644298,1393491,13.9,FL
185,2020,Jun,57.0,50.4,9956310,8798187,1158123,11.6,FL
186,2020,Jul,58.5,51.2,10225935,8949782,1276153,12.5,FL
187,2020,Aug,57.7,52.5,10098071,9196204,901867,8.9,FL
188,2020,Sep,58.1,53.1,10189980,9302447,887533,8.7,FL
189,2020,Oct,57.6,53.4,10099923,9377388,722535,7.2,FL
190,2020,Nov,57.5,53.7,10108485,9434846,673639,6.7,FL
191,2020,Dec,57.7,53.9,10136315,9480484,655831,6.5,FL
192,2021,Jan,57.6,54.1,10130459,9525658,604801,6.0,FL
193,2021,Feb,57.6,54.4,10147295,9578055,569240,5.6,FL
194,2021,Mar,57.8,54.7,10187675,9641957,545718,5.4,FL
195,2021,Apr,58.0,55.1,10233841,9711010,522831,5.1,FL
196,2021,May,58.2,55.4,10279255,9779931,499324,4.9,FL
197,2021,Jun,58.5,55.7,10339718,9840984,498734,4.8,FL
198,2021,Jul,58.6,55.9,10366760,9898454,468306,4.5,FL
199,2021,Aug,58.7,56.1,10398288,9950394,447894,4.3,FL
200,2021,Sep,58.6,56.3,10398117,9994587,403530,3.9,FL
201,2021,Oct,58.6,56.4,10415801,10029603,386198,3.7,FL
202,2021,Nov,58.5,56.4,10403809,10037181,366628,3.5,FL
203,2021,Dec,58.4,56.3,10400410,10036813,363597,3.5,FL
204,2022,Jan,58.6,56.5,10448575,10085178,363397,3.5,FL
205,2022,Feb,58.6,56.7,10470721,10123277,347444,3.3,FL
206,2022,Mar,58.8,56.9,10512852,10173851,339001,3.2,FL
207,2022,Apr,58.9,57.1,10542655,10221709,320946,3.0,FL
208,2022,May,59.1,57.4,10592689,10280328,312361,2.9,FL
209,2022,Jun,59.3,57.6,10632356,10330228,302128,2.8,FL
210,2022,Jul,59.3,57.7,10657055,10373885,283170,2.7,FL
211,2022,Aug,59.5,57.9,10705514,10412905,292609,2.7,FL
212,2022,Sep,59.5,58.0,10713511,10447351,266160,2.5,FL
213,2022,Oct,59.6,58.0,10749315,10464142,285173,2.7,FL
214,2022,Nov,59.5,58.0,10756364,10476487,279877,2.6,FL
0,2005,Jan,66.8,63.6,3376327,3211964,164363,4.9,MA
1,2005,Feb,66.8,63.6,3377030,3212794,164236,4.9,MA
2,2005,Mar,66.8,63.6,3378721,3215059,163662,4.8,MA
3,2005,Apr,66.9,63.7,3381335,3218651,162684,4.8,MA
4,2005,May,66.9,63.7,3384497,3222946,161551,4.8,MA
5,2005,Jun,66.9,63.8,3387355,3226660,160695,4.7,MA
6,2005,Jul,67.0,63.8,3389380,3228732,160648,4.7,MA
7,2005,Aug,66.9,63.8,3390341,3229086,161255,4.8,MA
8,2005,Sep,66.9,63.7,3390494,3228461,162033,4.8,MA
9,2005,Oct,66.8,63.6,3390374,3227977,162397,4.8,MA
10,2005,Nov,66.8,63.6,3390390,3228125,162265,4.8,MA
11,2005,Dec,66.7,63.6,3390351,3228651,161700,4.8,MA
12,2006,Jan,66.7,63.6,3390788,3229944,160844,4.7,MA
13,2006,Feb,66.7,63.6,3392290,3232254,160036,4.7,MA
14,2006,Mar,66.8,63.6,3394962,3235249,159713,4.7,MA
15,2006,Apr,66.8,63.7,3398710,3238568,160142,4.7,MA
16,2006,May,66.9,63.7,3403308,3242339,160969,4.7,MA
17,2006,Jun,67.0,63.8,3408276,3246530,161746,4.7,MA
18,2006,Jul,67.1,63.9,3413405,3251310,162095,4.7,MA
19,2006,Aug,67.1,63.9,3418840,3256631,162209,4.7,MA
20,2006,Sep,67.2,64.0,3424172,3261883,162289,4.7,MA
21,2006,Oct,67.2,64.0,3428730,3266745,161985,4.7,MA
22,2006,Nov,67.2,64.0,3432017,3270894,161123,4.7,MA
23,2006,Dec,67.2,64.1,3433704,3273958,159746,4.7,MA
24,2007,Jan,67.1,64.1,3434072,3275858,158214,4.6,MA
25,2007,Feb,67.1,64.0,3433865,3277054,156811,4.6,MA
26,2007,Mar,67.0,64.0,3433170,3277638,155532,4.5,MA
27,2007,Apr,67.0,64.0,3432208,3277798,154410,4.5,MA
28,2007,May,66.9,63.9,3431323,3277616,153707,4.5,MA
29,2007,Jun,66.9,63.9,3430837,3277367,153470,4.5,MA
30,2007,Jul,66.8,63.8,3430818,3277176,153642,4.5,MA
31,2007,Aug,66.8,63.8,3431305,3277143,154162,4.5,MA
32,2007,Sep,66.7,63.7,3432460,3277791,154669,4.5,MA
33,2007,Oct,66.7,63.7,3434433,3279271,155162,4.5,MA
34,2007,Nov,66.7,63.7,3437265,3281811,155454,4.5,MA
35,2007,Dec,66.7,63.7,3440566,3284993,155573,4.5,MA
36,2008,Jan,66.7,63.7,3443336,3287272,156064,4.5,MA
37,2008,Feb,66.7,63.7,3445463,3288107,157356,4.6,MA
38,2008,Mar,66.7,63.6,3448080,3288084,159996,4.6,MA
39,2008,Apr,66.7,63.6,3451857,3287651,164206,4.8,MA
40,2008,May,66.8,63.5,3457054,3287296,169758,4.9,MA
41,2008,Jun,66.9,63.4,3463575,3287364,176211,5.1,MA
42,2008,Jul,66.9,63.4,3470637,3287628,183009,5.3,MA
43,2008,Aug,67.0,63.3,3477120,3287107,190013,5.5,MA
44,2008,Sep,67.0,63.2,3481923,3284012,197911,5.7,MA
45,2008,Oct,67.0,63.0,3484355,3276874,207481,6.0,MA
46,2008,Nov,66.9,62.7,3484329,3265439,218890,6.3,MA
47,2008,Dec,66.9,62.4,3482788,3251176,231612,6.7,MA
48,2009,Jan,66.8,62.1,3480717,3236069,244648,7.0,MA
49,2009,Feb,66.7,61.7,3478984,3221939,257045,7.4,MA
50,2009,Mar,66.6,61.5,3478298,3210588,267710,7.7,MA
51,2009,Apr,66.6,61.3,3478483,3202508,275975,7.9,MA
52,2009,May,66.5,61.1,3478354,3196305,282049,8.1,MA
53,2009,Jun,66.4,60.9,3477099,3190727,286372,8.2,MA
54,2009,Jul,66.3,60.8,3474026,3184659,289367,8.3,MA
55,2009,Aug,66.2,60.6,3469286,3177920,291366,8.4,MA
56,2009,Sep,66.0,60.4,3464412,3171810,292602,8.4,MA
57,2009,Oct,65.9,60.3,3460868,3167575,293293,8.5,MA
58,2009,Nov,65.8,60.2,3460102,3166227,293875,8.5,MA
59,2009,Dec,65.8,60.2,3462787,3168295,294492,8.5,MA
60,2010,Jan,65.9,60.3,3468119,3173610,294509,8.5,MA
61,2010,Feb,66.0,60.4,3473982,3180656,293326,8.4,MA
62,2010,Mar,66.0,60.5,3478448,3187591,290857,8.4,MA
63,2010,Apr,66.6,61.1,3480846,3193516,287330,8.3,MA
64,2010,May,66.6,61.1,3481152,3198192,282960,8.1,MA
65,2010,Jun,66.4,61.1,3479736,3201063,278673,8.0,MA
66,2010,Jul,66.3,61.1,3478152,3202585,275567,7.9,MA
67,2010,Aug,66.3,61.0,3477864,3203993,273871,7.9,MA
68,2010,Sep,66.2,61.0,3478753,3205662,273091,7.9,MA
69,2010,Oct,66.2,61.0,3480429,3208079,272350,7.8,MA
70,2010,Nov,66.2,61.0,3482203,3211354,270849,7.8,MA
71,2010,Dec,66.1,61.0,3483339,3215075,268264,7.7,MA
72,2011,Jan,66.1,61.1,3483533,3218531,265002,7.6,MA
73,2011,Feb,66.0,61.0,3482261,3220677,261584,7.5,MA
74,2011,Mar,65.9,61.0,3479416,3221128,258288,7.4,MA
75,2011,Apr,65.8,61.0,3476255,3220663,255592,7.4,MA
76,2011,May,65.7,60.9,3474604,3220732,253872,7.3,MA
77,2011,Jun,65.7,60.9,3475347,3222636,252711,7.3,MA
78,2011,Jul,65.7,60.9,3478517,3227066,251451,7.2,MA
79,2011,Aug,65.7,61.0,3483335,3233573,249762,7.2,MA
80,2011,Sep,65.7,61.1,3488645,3241226,247419,7.1,MA
81,2011,Oct,65.8,61.2,3493484,3248942,244542,7.0,MA
82,2011,Nov,65.8,61.2,3496743,3255358,241385,6.9,MA
83,2011,Dec,65.7,61.3,3497899,3259580,238319,6.8,MA
84,2012,Jan,65.7,61.3,3498166,3262377,235789,6.7,MA
85,2012,Feb,65.6,61.3,3498974,3264746,234228,6.7,MA
86,2012,Mar,65.6,61.2,3500416,3266409,234007,6.7,MA
87,2012,Apr,65.6,61.2,3501752,3267063,234689,6.7,MA
88,2012,May,65.6,61.2,3503312,3267718,235594,6.7,MA
89,2012,Jun,65.5,61.1,3505430,3269278,236152,6.7,MA
90,2012,Jul,65.5,61.1,3507770,3271778,235992,6.7,MA
91,2012,Aug,65.5,61.1,3510235,3274743,235492,6.7,MA
92,2012,Sep,65.5,61.1,3512915,3277612,235303,6.7,MA
93,2012,Oct,65.5,61.1,3514788,3279317,235471,6.7,MA
94,2012,Nov,65.4,61.0,3515318,3279422,235896,6.7,MA
95,2012,Dec,65.3,61.0,3514801,3278423,236378,6.7,MA
96,2013,Jan,65.3,60.9,3513585,3276681,236904,6.7,MA
97,2013,Feb,65.2,60.8,3512599,3275220,237379,6.8,MA
98,2013,Mar,65.2,60.8,3513023,3275474,237549,6.8,MA
99,2013,Apr,65.2,60.8,3515403,3278014,237389,6.8,MA
100,2013,May,65.2,60.8,3518522,3281377,237145,6.7,MA
101,2013,Jun,65.1,60.8,3520920,3284024,236896,6.7,MA
102,2013,Jul,65.1,60.7,3521770,3285397,236373,6.7,MA
103,2013,Aug,65.0,60.7,3520422,3285726,234696,6.7,MA
104,2013,Sep,64.9,60.6,3517704,3286121,231583,6.6,MA
105,2013,Oct,64.8,60.6,3516257,3288254,228003,6.5,MA
106,2013,Nov,64.8,60.7,3517745,3293116,224629,6.4,MA
107,2013,Dec,64.8,60.7,3522182,3300577,221605,6.3,MA
108,2014,Jan,64.9,60.9,3528825,3310181,218644,6.2,MA
109,2014,Feb,65.0,61.0,3536741,3321159,215582,6.1,MA
110,2014,Mar,65.1,61.2,3544719,3331902,212817,6.0,MA
111,2014,Apr,65.2,61.3,3551300,3340784,210516,5.9,MA
112,2014,May,65.2,61.4,3556705,3348340,208365,5.9,MA
113,2014,Jun,65.3,61.5,3562788,3356523,206265,5.8,MA
114,2014,Jul,65.3,61.6,3570532,3366302,204230,5.7,MA
115,2014,Aug,65.5,61.8,3580091,3377865,202226,5.6,MA
116,2014,Sep,65.6,61.9,3590220,3390213,200007,5.6,MA
117,2014,Oct,65.7,62.1,3598416,3401460,196956,5.5,MA
118,2014,Nov,65.7,62.2,3602853,3409823,193030,5.4,MA
119,2014,Dec,65.7,62.3,3603769,3414729,189040,5.2,MA
120,2015,Jan,65.6,62.3,3602272,3416690,185582,5.2,MA
121,2015,Feb,65.6,62.2,3599631,3416731,182900,5.1,MA
122,2015,Mar,65.5,62.2,3597341,3416770,180571,5.0,MA
123,2015,Apr,65.4,62.2,3595870,3417689,178181,5.0,MA
124,2015,May,65.4,62.2,3594220,3418656,175564,4.9,MA
125,2015,Jun,65.3,62.1,3591258,3418552,172706,4.8,MA
126,2015,Jul,65.1,62.1,3587263,3417329,169934,4.7,MA
127,2015,Aug,65.0,62.0,3583181,3415653,167528,4.7,MA
128,2015,Sep,64.9,61.9,3580147,3414849,165298,4.6,MA
129,2015,Oct,64.9,61.9,3579727,3416493,163234,4.6,MA
130,2015,Nov,64.9,62.0,3582932,3421499,161433,4.5,MA
131,2015,Dec,65.0,62.1,3588507,3428990,159517,4.4,MA
132,2016,Jan,65.0,62.2,3594084,3436899,157185,4.4,MA
133,2016,Feb,65.1,62.3,3598443,3443921,154522,4.3,MA
134,2016,Mar,65.1,62.4,3601685,3450057,151628,4.2,MA
135,2016,Apr,65.1,62.4,3604987,3456132,148855,4.1,MA
136,2016,May,65.2,62.5,3609457,3462973,146484,4.1,MA
137,2016,Jun,65.2,62.6,3614771,3470308,144463,4.0,MA
138,2016,Jul,65.3,62.7,3620318,3477693,142625,3.9,MA
139,2016,Aug,65.3,62.8,3625768,3484610,141158,3.9,MA
140,2016,Sep,65.4,62.9,3630818,3490335,140483,3.9,MA
141,2016,Oct,65.4,62.9,3635097,3494693,140404,3.9,MA
142,2016,Nov,65.4,62.9,3639080,3498632,140448,3.9,MA
143,2016,Dec,65.5,63.0,3643795,3503296,140499,3.9,MA
144,2017,Jan,65.5,63.0,3689575,3547595,141980,3.8,MA
145,2017,Feb,65.6,63.1,3697820,3555672,142148,3.8,MA
146,2017,Mar,65.7,63.2,3706031,3563651,142380,3.8,MA
147,2017,Apr,65.8,63.3,3713689,3571035,142654,3.8,MA
148,2017,May,65.9,63.3,3720395,3577599,142796,3.8,MA
149,2017,Jun,65.9,63.4,3725928,3583056,142872,3.8,MA
150,2017,Jul,65.9,63.4,3730379,3587404,142975,3.8,MA
151,2017,Aug,66.0,63.4,3733717,3590897,142820,3.8,MA
152,2017,Sep,66.0,63.4,3736497,3594194,142303,3.8,MA
153,2017,Oct,66.0,63.5,3739791,3598295,141496,3.8,MA
154,2017,Nov,66.0,63.5,3744389,3603792,140597,3.8,MA
155,2017,Dec,66.1,63.7,3751631,3612149,139482,3.7,MA
156,2018,Jan,66.3,63.8,3762462,3624159,138303,3.7,MA
157,2018,Feb,66.5,64.1,3776694,3639458,137236,3.6,MA
158,2018,Mar,66.7,64.3,3792020,3655799,136221,3.6,MA
159,2018,Apr,66.9,64.6,3805229,3670154,135075,3.5,MA
160,2018,May,67.1,64.7,3814481,3680651,133830,3.5,MA
161,2018,Jun,67.1,64.8,3819644,3687249,132395,3.5,MA
162,2018,Jul,67.1,64.8,3821286,3690611,130675,3.4,MA
163,2018,Aug,67.1,64.8,3821460,3692376,129084,3.4,MA
164,2018,Sep,67.0,64.8,3821923,3693988,127935,3.3,MA
165,2018,Oct,67.0,64.8,3823448,3696338,127110,3.3,MA
166,2018,Nov,67.0,64.8,3825854,3699500,126354,3.3,MA
167,2018,Dec,67.0,64.8,3828505,3703075,125430,3.3,MA
168,2019,Jan,67.1,64.9,3830830,3706662,124168,3.2,MA
169,2019,Feb,67.1,64.9,3832624,3710262,122362,3.2,MA
170,2019,Mar,67.1,65.0,3834287,3713916,120371,3.1,MA
171,2019,Apr,67.1,65.0,3836026,3717504,118522,3.1,MA
172,2019,May,67.1,65.0,3837165,3720073,117092,3.1,MA
173,2019,Jun,67.0,65.0,3837314,3721038,116276,3.0,MA
174,2019,Jul,67.0,65.0,3836232,3720222,116010,3.0,MA
175,2019,Aug,66.9,64.9,3833830,3717967,115863,3.0,MA
176,2019,Sep,66.8,64.8,3831205,3715973,115232,3.0,MA
177,2019,Oct,66.8,64.8,3829100,3714517,114583,3.0,MA
178,2019,Nov,66.7,64.7,3826687,3712543,114144,3.0,MA
179,2019,Dec,66.6,64.6,3820439,3706765,113674,3.0,MA
180,2020,Jan,66.3,64.3,3807244,3694453,112791,3.0,MA
181,2020,Feb,65.9,64.0,3786577,3675271,111306,2.9,MA
182,2020,Mar,65.5,63.6,3761042,3652180,108862,2.9,MA
183,2020,Apr,60.5,50.1,3475101,2880659,594442,17.1,MA
184,2020,May,64.7,54.7,3717504,3140757,576747,15.5,MA
185,2020,Jun,65.6,56.1,3766243,3222471,543772,14.4,MA
186,2020,Jul,65.8,57.4,3778049,3297726,480323,12.7,MA
187,2020,Aug,65.4,58.4,3753920,3355291,398629,10.6,MA
188,2020,Sep,65.8,59.3,3774648,3402292,372356,9.9,MA
189,2020,Oct,65.4,59.8,3755312,3431706,323606,8.6,MA
190,2020,Nov,65.4,60.1,3753791,3450317,303474,8.1,MA
191,2020,Dec,65.4,60.3,3751090,3461660,289430,7.7,MA
192,2021,Jan,65.2,60.5,3735564,3471394,264170,7.1,MA
193,2021,Feb,65.1,60.8,3733549,3482778,250771,6.7,MA
194,2021,Mar,65.2,61.0,3735369,3496710,238659,6.4,MA
195,2021,Apr,65.4,61.3,3747684,3511472,236212,6.3,MA
196,2021,May,65.4,61.6,3747620,3524818,222802,5.9,MA
197,2021,Jun,65.7,61.7,3760383,3535247,225136,6.0,MA
198,2021,Jul,65.6,61.9,3757242,3544583,212659,5.7,MA
199,2021,Aug,65.7,62.1,3758938,3553248,205690,5.5,MA
200,2021,Sep,65.6,62.2,3755821,3562569,193252,5.1,MA
201,2021,Oct,65.7,62.4,3759342,3571398,187944,5.0,MA
202,2021,Nov,65.6,62.4,3754708,3575515,179193,4.8,MA
203,2021,Dec,65.5,62.5,3751493,3577297,174196,4.6,MA
204,2022,Jan,65.8,62.7,3766929,3586625,180304,4.8,MA
205,2022,Feb,65.9,62.9,3772543,3596655,175888,4.7,MA
206,2022,Mar,66.0,63.2,3775148,3614665,160483,4.3,MA
207,2022,Apr,66.0,63.3,3775535,3621679,153856,4.1,MA
208,2022,May,66.0,63.5,3775559,3629440,146119,3.9,MA
209,2022,Jun,66.0,63.5,3773063,3633845,139218,3.7,MA
210,2022,Jul,65.8,63.5,3765479,3634582,130897,3.5,MA
211,2022,Aug,65.8,63.4,3762959,3628217,134742,3.6,MA
212,2022,Sep,65.6,63.3,3749608,3620625,128983,3.4,MA
213,2022,Oct,65.5,63.2,3745591,3614502,131089,3.5,MA
214,2022,Nov,65.3,63.1,3732564,3607232,125332,3.4,MA
0,2005,Jan,61.6,58.5,2131703,2025399,106304,5.0,AL
1,2005,Feb,61.6,58.6,2131888,2028403,103485,4.9,AL
2,2005,Mar,61.5,58.6,2132542,2032012,100530,4.7,AL
3,2005,Apr,61.5,58.7,2133797,2036225,97572,4.6,AL
4,2005,May,61.5,58.8,2135881,2040891,94990,4.4,AL
5,2005,Jun,61.6,58.9,2138558,2045463,93095,4.4,AL
6,2005,Jul,61.6,59.0,2141446,2049425,92021,4.3,AL
7,2005,Aug,61.6,59.0,2144070,2052511,91559,4.3,AL
8,2005,Sep,61.6,59.0,2146009,2054667,91342,4.3,AL
9,2005,Oct,61.5,58.9,2147374,2056388,90986,4.2,AL
10,2005,Nov,61.5,58.9,2148494,2058020,90474,4.2,AL
11,2005,Dec,61.4,58.9,2149633,2059843,89790,4.2,AL
12,2006,Jan,61.4,58.9,2151174,2062219,88955,4.1,AL
13,2006,Feb,61.4,58.9,2153411,2065225,88186,4.1,AL
14,2006,Mar,61.4,58.9,2156335,2068505,87830,4.1,AL
15,2006,Apr,61.5,59.0,2159713,2071802,87911,4.1,AL
16,2006,May,61.5,59.0,2163359,2075386,87973,4.1,AL
17,2006,Jun,61.6,59.1,2167159,2079399,87760,4.0,AL
18,2006,Jul,61.6,59.1,2171367,2084065,87302,4.0,AL
19,2006,Aug,61.7,59.2,2176026,2089301,86725,4.0,AL
20,2006,Sep,61.8,59.3,2180689,2094591,86098,3.9,AL
21,2006,Oct,61.8,59.4,2184587,2099223,85364,3.9,AL
22,2006,Nov,61.8,59.4,2187215,2102582,84633,3.9,AL
23,2006,Dec,61.8,59.4,2188157,2104100,84057,3.8,AL
24,2007,Jan,61.7,59.4,2187339,2103550,83789,3.8,AL
25,2007,Feb,61.6,59.3,2185202,2101371,83831,3.8,AL
26,2007,Mar,61.5,59.1,2182257,2098155,84102,3.9,AL
27,2007,Apr,61.4,59.0,2179466,2094744,84722,3.9,AL
28,2007,May,61.3,58.9,2177514,2091810,85704,3.9,AL
29,2007,Jun,61.2,58.8,2176642,2089809,86833,4.0,AL
30,2007,Jul,61.2,58.7,2176801,2088783,88018,4.0,AL
31,2007,Aug,61.1,58.6,2177930,2088560,89370,4.1,AL
32,2007,Sep,61.1,58.6,2179782,2088878,90904,4.2,AL
33,2007,Oct,61.1,58.5,2181628,2088944,92684,4.2,AL
34,2007,Nov,61.1,58.5,2182775,2088237,94538,4.3,AL
35,2007,Dec,61.1,58.4,2183086,2086564,96522,4.4,AL
36,2008,Jan,61.0,58.3,2182712,2083744,98968,4.5,AL
37,2008,Feb,61.0,58.1,2182002,2079970,102032,4.7,AL
38,2008,Mar,60.9,57.9,2181312,2075441,105871,4.9,AL
39,2008,Apr,60.8,57.7,2180544,2070085,110459,5.1,AL
40,2008,May,60.8,57.5,2179601,2063894,115707,5.3,AL
41,2008,Jun,60.7,57.3,2178622,2057140,121482,5.6,AL
42,2008,Jul,60.6,57.0,2177334,2049897,127437,5.9,AL
43,2008,Aug,60.5,56.8,2175532,2041980,133552,6.1,AL
44,2008,Sep,60.4,56.5,2173629,2033141,140488,6.5,AL
45,2008,Oct,60.3,56.2,2172322,2023364,148958,6.9,AL
46,2008,Nov,60.2,55.8,2171630,2012593,159037,7.3,AL
47,2008,Dec,60.2,55.5,2171169,2001037,170132,7.8,AL
48,2009,Jan,60.1,55.1,2170615,1989308,181307,8.4,AL
49,2009,Feb,60.1,54.8,2169888,1978083,191805,8.8,AL
50,2009,Mar,60.0,54.5,2168962,1968035,200927,9.3,AL
51,2009,Apr,60.0,54.2,2167672,1959272,208400,9.6,AL
52,2009,May,59.9,53.9,2165514,1950906,214608,9.9,AL
53,2009,Jun,59.7,53.7,2162128,1942142,219986,10.2,AL
54,2009,Jul,59.6,53.4,2157556,1932774,224782,10.4,AL
55,2009,Aug,59.4,53.1,2152222,1923196,229026,10.6,AL
56,2009,Sep,59.2,52.8,2146808,1914421,232387,10.8,AL
57,2009,Oct,59.0,52.5,2142208,1907643,234565,10.9,AL
58,2009,Nov,58.9,52.4,2139947,1904011,235936,11.0,AL
59,2009,Dec,58.9,52.4,2140674,1903811,236863,11.1,AL
60,2010,Jan,58.9,52.4,2143297,1906185,237112,11.1,AL
61,2010,Feb,59.0,52.5,2145780,1909481,236299,11.0,AL
62,2010,Mar,59.0,52.5,2146904,1912541,234363,10.9,AL
63,2010,Apr,59.4,53.2,2197720,1966202,231518,10.5,AL
64,2010,May,59.8,53.6,2211777,1983756,228021,10.3,AL
65,2010,Jun,59.8,53.7,2214822,1990063,224759,10.1,AL
66,2010,Jul,59.8,53.8,2215237,1992482,222755,10.1,AL
67,2010,Aug,59.7,53.8,2215825,1993456,222369,10.0,AL
68,2010,Sep,59.7,53.7,2216902,1993580,223322,10.1,AL
69,2010,Oct,59.7,53.7,2217869,1993177,224692,10.1,AL
70,2010,Nov,59.7,53.6,2217791,1992440,225351,10.2,AL
71,2010,Dec,59.6,53.6,2216409,1991718,224691,10.1,AL
72,2011,Jan,59.6,53.6,2214624,1991574,223050,10.1,AL
73,2011,Feb,59.5,53.6,2212917,1991849,221068,10.0,AL
74,2011,Mar,59.4,53.6,2210958,1991840,219118,9.9,AL
75,2011,Apr,59.4,53.5,2208488,1990933,217555,9.9,AL
76,2011,May,59.3,53.4,2205934,1989359,216575,9.8,AL
77,2011,Jun,59.2,53.4,2203524,1987938,215586,9.8,AL
78,2011,Jul,59.1,53.4,2201393,1987565,213828,9.7,AL
79,2011,Aug,59.0,53.4,2199378,1988543,210835,9.6,AL
80,2011,Sep,58.9,53.4,2197051,1990625,206426,9.4,AL
81,2011,Oct,58.8,53.4,2194108,1992980,201128,9.2,AL
82,2011,Nov,58.7,53.4,2190069,1994495,195574,8.9,AL
83,2011,Dec,58.5,53.4,2185010,1994618,190392,8.7,AL
84,2012,Jan,58.3,53.4,2179750,1993523,186227,8.5,AL
85,2012,Feb,58.2,53.3,2175635,1992089,183546,8.4,AL
86,2012,Mar,58.1,53.2,2173644,1991104,182540,8.4,AL
87,2012,Apr,58.1,53.2,2173494,1991037,182457,8.4,AL
88,2012,May,58.1,53.2,2174754,1992484,182270,8.4,AL
89,2012,Jun,58.1,53.3,2176818,1995546,181272,8.3,AL
90,2012,Jul,58.2,53.4,2178985,1999860,179125,8.2,AL
91,2012,Aug,58.2,53.5,2180942,2004716,176226,8.1,AL
92,2012,Sep,58.2,53.6,2182771,2009352,173419,7.9,AL
93,2012,Oct,58.2,53.6,2184006,2012918,171088,7.8,AL
94,2012,Nov,58.2,53.7,2184400,2015057,169343,7.8,AL
95,2012,Dec,58.1,53.7,2183700,2015725,167975,7.7,AL
96,2013,Jan,58.1,53.6,2181651,2015043,166608,7.6,AL
97,2013,Feb,58.0,53.6,2178756,2013876,164880,7.6,AL
98,2013,Mar,57.9,53.5,2175993,2013323,162670,7.5,AL
99,2013,Apr,57.8,53.5,2174613,2014210,160403,7.4,AL
100,2013,May,57.8,53.6,2174482,2015808,158674,7.3,AL
101,2013,Jun,57.8,53.6,2174677,2016898,157779,7.3,AL
102,2013,Jul,57.7,53.5,2174320,2016720,157600,7.2,AL
103,2013,Aug,57.7,53.5,2172637,2015204,157433,7.2,AL
104,2013,Sep,57.6,53.4,2169847,2013022,156825,7.2,AL
105,2013,Oct,57.5,53.3,2167230,2011093,156137,7.2,AL
106,2013,Nov,57.4,53.3,2165715,2010028,155687,7.2,AL
107,2013,Dec,57.4,53.2,2165388,2009949,155439,7.2,AL
108,2014,Jan,57.4,53.3,2165971,2010942,155029,7.2,AL
109,2014,Feb,57.4,53.3,2166876,2012653,154223,7.1,AL
110,2014,Mar,57.4,53.3,2167429,2014263,153166,7.1,AL
111,2014,Apr,57.3,53.3,2166887,2015052,151835,7.0,AL
112,2014,May,57.3,53.3,2165427,2015410,150017,6.9,AL
113,2014,Jun,57.2,53.3,2164102,2016249,147853,6.8,AL
114,2014,Jul,57.2,53.3,2163245,2017648,145597,6.7,AL
115,2014,Aug,57.1,53.4,2162943,2019514,143429,6.6,AL
116,2014,Sep,57.1,53.4,2162865,2021615,141250,6.5,AL
117,2014,Oct,57.1,53.4,2162682,2023989,138693,6.4,AL
118,2014,Nov,57.1,53.5,2162723,2026910,135813,6.3,AL
119,2014,Dec,57.1,53.6,2163996,2030603,133393,6.2,AL
120,2015,Jan,57.1,53.6,2166771,2034786,131985,6.1,AL
121,2015,Feb,57.2,53.7,2170601,2038928,131673,6.1,AL
122,2015,Mar,57.3,53.8,2174960,2042936,132024,6.1,AL
123,2015,Apr,57.2,53.7,2170166,2037552,132614,6.1,AL
124,2015,May,57.0,53.5,2164519,2031470,133049,6.1,AL
125,2015,Jun,56.8,53.3,2157472,2024484,132988,6.2,AL
126,2015,Jul,56.6,53.1,2149701,2017218,132483,6.2,AL
127,2015,Aug,56.4,52.9,2142296,2010491,131805,6.2,AL
128,2015,Sep,56.2,52.7,2136055,2004972,131083,6.1,AL
129,2015,Oct,56.1,52.7,2135797,2005232,130565,6.1,AL
130,2015,Nov,55.9,52.5,2127937,1997567,130370,6.1,AL
131,2015,Dec,56.0,52.6,2133700,2003525,130175,6.1,AL
132,2016,Jan,56.2,52.8,2138981,2009234,129747,6.1,AL
133,2016,Feb,56.3,52.9,2143456,2014380,129076,6.0,AL
134,2016,Mar,56.3,53.0,2146821,2018777,128044,6.0,AL
135,2016,Apr,56.4,53.0,2149261,2022346,126915,5.9,AL
136,2016,May,56.4,53.1,2151573,2025350,126223,5.9,AL
137,2016,Jun,56.5,53.2,2154315,2028210,126105,5.9,AL
138,2016,Jul,56.5,53.2,2157474,2031143,126331,5.9,AL
139,2016,Aug,56.6,53.3,2160744,2034025,126719,5.9,AL
140,2016,Sep,56.6,53.3,2163777,2036649,127128,5.9,AL
141,2016,Oct,56.7,53.3,2166110,2039127,126983,5.9,AL
142,2016,Nov,56.7,53.4,2167734,2042073,125661,5.8,AL
143,2016,Dec,56.7,53.5,2168771,2045834,122937,5.7,AL
144,2017,Jan,56.7,53.6,2199177,2079074,120103,5.5,AL
145,2017,Feb,56.7,53.7,2199698,2084290,115408,5.2,AL
146,2017,Mar,56.7,53.8,2200069,2089481,110588,5.0,AL
147,2017,Apr,56.7,53.9,2200718,2094737,105981,4.8,AL
148,2017,May,56.7,54.0,2201642,2100033,101609,4.6,AL
149,2017,Jun,56.7,54.1,2202497,2104727,97770,4.4,AL
150,2017,Jul,56.6,54.2,2203232,2108489,94743,4.3,AL
151,2017,Aug,56.6,54.2,2203843,2111469,92374,4.2,AL
152,2017,Sep,56.6,54.3,2204575,2114006,90569,4.1,AL
153,2017,Oct,56.6,54.3,2205842,2116522,89320,4.0,AL
154,2017,Nov,56.6,54.4,2207993,2119284,88709,4.0,AL
155,2017,Dec,56.7,54.4,2211270,2122773,88497,4.0,AL
156,2018,Jan,56.8,54.5,2215937,2127350,88587,4.0,AL
157,2018,Feb,56.9,54.7,2222103,2133317,88786,4.0,AL
158,2018,Mar,57.1,54.8,2228853,2139997,88856,4.0,AL
159,2018,Apr,57.2,54.9,2234574,2145919,88655,4.0,AL
160,2018,May,57.3,55.0,2238465,2150167,88298,3.9,AL
161,2018,Jun,57.3,55.1,2240876,2153088,87788,3.9,AL
162,2018,Jul,57.3,55.1,2242350,2155244,87106,3.9,AL
163,2018,Aug,57.3,55.1,2243996,2157370,86626,3.9,AL
164,2018,Sep,57.4,55.1,2246632,2160101,86531,3.9,AL
165,2018,Oct,57.4,55.2,2250621,2163967,86654,3.9,AL
166,2018,Nov,57.5,55.3,2255669,2168950,86719,3.8,AL
167,2018,Dec,57.6,55.4,2261102,2174814,86288,3.8,AL
168,2019,Jan,57.7,55.6,2265764,2180940,84824,3.7,AL
169,2019,Feb,57.8,55.7,2268650,2186701,81949,3.6,AL
170,2019,Mar,57.8,55.8,2269750,2191746,78004,3.4,AL
171,2019,Apr,57.8,55.9,2269762,2196117,73645,3.2,AL
172,2019,May,57.7,56.0,2269477,2199812,69665,3.1,AL
173,2019,Jun,57.7,56.0,2269511,2202685,66826,2.9,AL
174,2019,Jul,57.7,56.0,2270281,2204772,65509,2.9,AL
175,2019,Aug,57.7,56.0,2271806,2206223,65583,2.9,AL
176,2019,Sep,57.7,56.0,2273771,2207294,66477,2.9,AL
177,2019,Oct,57.7,56.0,2275680,2207568,68112,3.0,AL
178,2019,Nov,57.7,55.9,2276674,2206498,70176,3.1,AL
179,2019,Dec,57.6,55.8,2275425,2202912,72513,3.2,AL
180,2020,Jan,57.5,55.6,2271707,2196647,75060,3.3,AL
181,2020,Feb,57.4,55.4,2266396,2188425,77971,3.4,AL
182,2020,Mar,57.2,55.2,2261366,2180272,81094,3.6,AL
183,2020,Apr,55.4,47.8,2189708,1890788,298920,13.7,AL
184,2020,May,57.4,51.5,2270749,2035223,235526,10.4,AL
185,2020,Jun,57.5,52.5,2276235,2077480,198755,8.7,AL
186,2020,Jul,57.8,53.4,2287268,2111266,176002,7.7,AL
187,2020,Aug,57.7,53.9,2285319,2134930,150389,6.6,AL
188,2020,Sep,57.8,54.3,2290413,2151241,139172,6.1,AL
189,2020,Oct,57.5,54.5,2280554,2159691,120863,5.3,AL
190,2020,Nov,57.3,54.6,2271915,2162940,108975,4.8,AL
191,2020,Dec,57.1,54.6,2263225,2163877,99348,4.4,AL
192,2021,Jan,56.9,54.6,2255058,2164668,90390,4.0,AL
193,2021,Feb,56.8,54.6,2251260,2166202,85058,3.8,AL
194,2021,Mar,56.7,54.6,2250687,2168244,82443,3.7,AL
195,2021,Apr,56.7,54.7,2251194,2169595,81599,3.6,AL
196,2021,May,56.7,54.6,2249901,2169710,80191,3.6,AL
197,2021,Jun,56.6,54.6,2247768,2168329,79439,3.5,AL
198,2021,Jul,56.5,54.5,2244144,2167068,77076,3.4,AL
199,2021,Aug,56.3,54.5,2241293,2166788,74505,3.3,AL
200,2021,Sep,56.3,54.5,2240353,2168364,71989,3.2,AL
201,2021,Oct,56.3,54.5,2241442,2170873,70569,3.1,AL
202,2021,Nov,56.2,54.5,2242078,2172390,69688,3.1,AL
203,2021,Dec,56.2,54.5,2242275,2172841,69434,3.1,AL
204,2022,Jan,56.4,54.7,2250343,2181218,69125,3.1,AL
205,2022,Feb,56.6,54.9,2260562,2191899,68663,3.0,AL
206,2022,Mar,56.8,55.2,2270352,2204911,65441,2.9,AL
207,2022,Apr,57.0,55.4,2276371,2213187,63184,2.8,AL
208,2022,May,57.1,55.6,2284510,2222925,61585,2.7,AL
209,2022,Jun,57.2,55.7,2288580,2228273,60307,2.6,AL
210,2022,Jul,57.2,55.7,2291833,2232474,59359,2.6,AL
211,2022,Aug,57.2,55.8,2293693,2234780,58913,2.6,AL
212,2022,Sep,57.2,55.7,2294660,2235140,59520,2.6,AL
213,2022,Oct,57.2,55.6,2294823,2233102,61721,2.7,AL
214,2022,Nov,57.1,55.5,2292936,2229893,63043,2.7,AL
0,2005,Jan,68.1,64.1,3006569,2827349,179220,6.0,MO
1,2005,Feb,68.1,64.1,3008233,2830213,178020,5.9,MO
2,2005,Mar,68.1,64.1,3009365,2833780,175585,5.8,MO
3,2005,Apr,68.1,64.2,3009723,2838010,171713,5.7,MO
4,2005,May,68.0,64.2,3009592,2842877,166715,5.5,MO
5,2005,Jun,67.9,64.3,3009473,2847827,161646,5.4,MO
6,2005,Jul,67.9,64.3,3009855,2852209,157646,5.2,MO
7,2005,Aug,67.8,64.3,3010684,2855649,155035,5.1,MO
8,2005,Sep,67.8,64.3,3011492,2857909,153583,5.1,MO
9,2005,Oct,67.6,64.2,3012033,2859392,152641,5.1,MO
10,2005,Nov,67.6,64.2,3012555,2860770,151785,5.0,MO
11,2005,Dec,67.5,64.2,3013355,2862756,150599,5.0,MO
12,2006,Jan,67.5,64.2,3014631,2865710,148921,4.9,MO
13,2006,Feb,67.5,64.2,3016412,2869483,146929,4.9,MO
14,2006,Mar,67.5,64.2,3019077,2873689,145388,4.8,MO
15,2006,Apr,67.5,64.3,3022984,2877879,145105,4.8,MO
16,2006,May,67.6,64.3,3028016,2882003,146013,4.8,MO
17,2006,Jun,67.6,64.3,3033601,2886066,147535,4.9,MO
18,2006,Jul,67.7,64.4,3039402,2890439,148963,4.9,MO
19,2006,Aug,67.8,64.4,3045228,2895141,150087,4.9,MO
20,2006,Sep,67.8,64.5,3050585,2899808,150777,4.9,MO
21,2006,Oct,67.9,64.5,3054914,2904208,150706,4.9,MO
22,2006,Nov,67.9,64.5,3057697,2907850,149847,4.9,MO
23,2006,Dec,67.8,64.5,3058416,2909972,148444,4.9,MO
24,2007,Jan,67.7,64.5,3057457,2910257,147200,4.8,MO
25,2007,Feb,67.7,64.4,3055861,2909172,146689,4.8,MO
26,2007,Mar,67.6,64.3,3054108,2907025,147083,4.8,MO
27,2007,Apr,67.5,64.2,3052781,2904486,148295,4.9,MO
28,2007,May,67.4,64.1,3052676,2902173,150503,4.9,MO
29,2007,Jun,67.4,64.0,3053868,2900452,153416,5.0,MO
30,2007,Jul,67.4,64.0,3056144,2899507,156637,5.1,MO
31,2007,Aug,67.4,63.9,3059270,2899435,159835,5.2,MO
32,2007,Sep,67.4,63.8,3062504,2900171,162333,5.3,MO
33,2007,Oct,67.4,63.8,3064788,2900818,163970,5.4,MO
34,2007,Nov,67.4,63.7,3065589,2900868,164721,5.4,MO
35,2007,Dec,67.3,63.7,3065251,2900324,164927,5.4,MO
36,2008,Jan,67.2,63.6,3064242,2899013,165229,5.4,MO
37,2008,Feb,67.2,63.5,3063107,2897024,166083,5.4,MO
38,2008,Mar,67.1,63.4,3062698,2894477,168221,5.5,MO
39,2008,Apr,67.1,63.3,3063138,2891182,171956,5.6,MO
40,2008,May,67.0,63.2,3063984,2886999,176985,5.8,MO
41,2008,Jun,67.0,63.0,3064984,2882201,182783,6.0,MO
42,2008,Jul,67.0,62.8,3065820,2876896,188924,6.2,MO
43,2008,Aug,66.9,62.7,3066259,2870988,195271,6.4,MO
44,2008,Sep,66.9,62.5,3066669,2864204,202465,6.6,MO
45,2008,Oct,66.9,62.3,3067640,2856334,211306,6.9,MO
46,2008,Nov,66.8,62.0,3069076,2847323,221753,7.2,MO
47,2008,Dec,66.8,61.8,3070614,2837411,233203,7.6,MO
48,2009,Jan,66.8,61.5,3072024,2827112,244912,8.0,MO
49,2009,Feb,66.8,61.3,3073323,2817179,256144,8.3,MO
50,2009,Mar,66.8,61.1,3074303,2808736,265567,8.6,MO
51,2009,Apr,66.8,60.9,3074803,2802257,272546,8.9,MO
52,2009,May,66.8,60.7,3074117,2796764,277353,9.0,MO
53,2009,Jun,66.7,60.6,3071762,2791064,280698,9.1,MO
54,2009,Jul,66.5,60.4,3067274,2784144,283130,9.2,MO
55,2009,Aug,66.3,60.2,3060731,2775832,284899,9.3,MO
56,2009,Sep,66.1,59.9,3053430,2767093,286337,9.4,MO
57,2009,Oct,65.9,59.7,3046720,2759008,287712,9.4,MO
58,2009,Nov,65.8,59.5,3042320,2752712,289608,9.5,MO
59,2009,Dec,65.7,59.4,3041155,2749112,292043,9.6,MO
60,2010,Jan,65.7,59.4,3042296,2748478,293818,9.7,MO
61,2010,Feb,65.7,59.4,3043869,2749657,294212,9.7,MO
62,2010,Mar,65.7,59.4,3044587,2751280,293307,9.6,MO
63,2010,Apr,65.9,59.6,3044286,2752890,291396,9.6,MO
64,2010,May,65.8,59.6,3043234,2754497,288737,9.5,MO
65,2010,Jun,65.8,59.6,3041931,2755633,286298,9.4,MO
66,2010,Jul,65.7,59.6,3041121,2756025,285096,9.4,MO
67,2010,Aug,65.7,59.5,3041423,2755882,285541,9.4,MO
68,2010,Sep,65.7,59.5,3042363,2755310,287053,9.4,MO
69,2010,Oct,65.7,59.4,3043450,2755173,288277,9.5,MO
70,2010,Nov,65.7,59.4,3043917,2755917,288000,9.5,MO
71,2010,Dec,65.6,59.5,3043280,2757397,285883,9.4,MO
72,2011,Jan,65.6,59.5,3042146,2759423,282723,9.3,MO
73,2011,Feb,65.5,59.5,3040520,2761650,278870,9.2,MO
74,2011,Mar,65.4,59.5,3038234,2763601,274633,9.0,MO
75,2011,Apr,65.4,59.5,3035428,2764617,270811,8.9,MO
76,2011,May,65.3,59.5,3032973,2764945,268028,8.8,MO
77,2011,Jun,65.2,59.5,3031540,2765678,265862,8.8,MO
78,2011,Jul,65.2,59.5,3031325,2767805,263520,8.7,MO
79,2011,Aug,65.2,59.6,3031636,2771395,260241,8.6,MO
80,2011,Sep,65.1,59.6,3031257,2775879,255378,8.4,MO
81,2011,Oct,65.1,59.7,3029495,2780269,249226,8.2,MO
82,2011,Nov,65.0,59.8,3025832,2783434,242398,8.0,MO
83,2011,Dec,64.8,59.8,3020372,2784865,235507,7.8,MO
84,2012,Jan,64.7,59.7,3013958,2784819,229139,7.6,MO
85,2012,Feb,64.5,59.7,3008235,2784077,224158,7.5,MO
86,2012,Mar,64.4,59.7,3004112,2783008,221104,7.4,MO
87,2012,Apr,64.3,59.6,3001221,2782139,219082,7.3,MO
88,2012,May,64.3,59.6,2999746,2782417,217329,7.2,MO
89,2012,Jun,64.2,59.6,2999577,2784194,215383,7.2,MO
90,2012,Jul,64.2,59.7,3000439,2787304,213135,7.1,MO
91,2012,Aug,64.2,59.7,3002370,2791175,211195,7.0,MO
92,2012,Sep,64.3,59.8,3005264,2795016,210248,7.0,MO
93,2012,Oct,64.3,59.8,3007710,2797738,209972,7.0,MO
94,2012,Nov,64.3,59.8,3008994,2799168,209826,7.0,MO
95,2012,Dec,64.3,59.8,3009177,2799741,209436,7.0,MO
96,2013,Jan,64.3,59.8,3008594,2799781,208813,6.9,MO
97,2013,Feb,64.2,59.8,3008137,2800121,208016,6.9,MO
98,2013,Mar,64.2,59.8,3008816,2801682,207134,6.9,MO
99,2013,Apr,64.3,59.9,3011278,2804770,206508,6.9,MO
100,2013,May,64.3,59.9,3014209,2808028,206181,6.8,MO
101,2013,Jun,64.3,59.9,3015995,2810122,205873,6.8,MO
102,2013,Jul,64.3,59.9,3015876,2810658,205218,6.8,MO
103,2013,Aug,64.2,59.9,3013797,2810184,203613,6.8,MO
104,2013,Sep,64.1,59.8,3011160,2809780,201380,6.7,MO
105,2013,Oct,64.1,59.8,3010507,2810589,199918,6.6,MO
106,2013,Nov,64.1,59.9,3012981,2813239,199742,6.6,MO
107,2013,Dec,64.2,59.9,3017799,2817410,200389,6.6,MO
108,2014,Jan,64.3,60.0,3023454,2822595,200859,6.6,MO
109,2014,Feb,64.4,60.1,3028252,2827952,200300,6.6,MO
110,2014,Mar,64.4,60.2,3030991,2832619,198372,6.5,MO
111,2014,Apr,64.4,60.2,3031462,2836109,195353,6.4,MO
112,2014,May,64.4,60.3,3030820,2839226,191594,6.3,MO
113,2014,Jun,64.3,60.3,3030914,2843247,187667,6.2,MO
114,2014,Jul,64.3,60.4,3032475,2848329,184146,6.1,MO
115,2014,Aug,64.4,60.5,3035691,2854353,181338,6.0,MO
116,2014,Sep,64.4,60.6,3039992,2860932,179060,5.9,MO
117,2014,Oct,64.5,60.7,3044054,2867348,176706,5.8,MO
118,2014,Nov,64.5,60.8,3047123,2872738,174385,5.7,MO
119,2014,Dec,64.6,60.9,3049812,2877073,172739,5.7,MO
120,2015,Jan,64.6,61.0,3052395,2880669,171726,5.6,MO
121,2015,Feb,64.6,61.0,3054756,2883759,170997,5.6,MO
122,2015,Mar,64.6,61.1,3056791,2887036,169755,5.6,MO
123,2015,Apr,64.7,61.1,3058205,2890940,167265,5.5,MO
124,2015,May,64.6,61.2,3058587,2895171,163416,5.3,MO
125,2015,Jun,64.6,61.2,3057937,2899170,158767,5.2,MO
126,2015,Jul,64.5,61.3,3056934,2902982,153952,5.0,MO
127,2015,Aug,64.5,61.4,3056343,2906823,149520,4.9,MO
128,2015,Sep,64.5,61.4,3056675,2911038,145637,4.8,MO
129,2015,Oct,64.5,61.5,3058618,2916130,142488,4.7,MO
130,2015,Nov,64.6,61.6,3062018,2921813,140205,4.6,MO
131,2015,Dec,64.6,61.7,3065552,2927136,138416,4.5,MO
132,2016,Jan,64.7,61.8,3068547,2931518,137029,4.5,MO
133,2016,Feb,64.7,61.8,3070971,2934662,136309,4.4,MO
134,2016,Mar,64.7,61.8,3072852,2936300,136552,4.4,MO
135,2016,Apr,64.7,61.8,3074491,2936456,138035,4.5,MO
136,2016,May,64.7,61.8,3076191,2935649,140542,4.6,MO
137,2016,Jun,64.7,61.7,3077577,2934414,143163,4.7,MO
138,2016,Jul,64.7,61.7,3078141,2933221,144920,4.7,MO
139,2016,Aug,64.7,61.6,3077411,2932194,145217,4.7,MO
140,2016,Sep,64.6,61.6,3075144,2931162,143982,4.7,MO
141,2016,Oct,64.5,61.5,3071352,2930190,141162,4.6,MO
142,2016,Nov,64.4,61.5,3066907,2929960,136947,4.5,MO
143,2016,Dec,64.3,61.5,3063183,2930971,132212,4.3,MO
144,2017,Jan,64.1,61.5,3057505,2929500,128005,4.2,MO
145,2017,Feb,64.1,61.5,3056298,2932205,124093,4.1,MO
146,2017,Mar,64.1,61.5,3055779,2935285,120494,3.9,MO
147,2017,Apr,64.1,61.6,3055812,2938558,117254,3.8,MO
148,2017,May,64.0,61.6,3056058,2941772,114286,3.7,MO
149,2017,Jun,64.0,61.7,3056124,2944244,111880,3.7,MO
150,2017,Jul,64.0,61.7,3055731,2945386,110345,3.6,MO
151,2017,Aug,63.9,61.6,3054426,2944891,109535,3.6,MO
152,2017,Sep,63.9,61.6,3052116,2942970,109146,3.6,MO
153,2017,Oct,63.8,61.5,3049100,2940292,108808,3.6,MO
154,2017,Nov,63.7,61.4,3046091,2937776,108315,3.6,MO
155,2017,Dec,63.6,61.4,3044088,2936798,107290,3.5,MO
156,2018,Jan,63.6,61.4,3043895,2938178,105717,3.5,MO
157,2018,Feb,63.7,61.5,3045732,2942039,103693,3.4,MO
158,2018,Mar,63.7,61.6,3048267,2947208,101059,3.3,MO
159,2018,Apr,63.7,61.7,3049572,2951639,97933,3.2,MO
160,2018,May,63.7,61.7,3048818,2953852,94966,3.1,MO
161,2018,Jun,63.6,61.7,3046437,2953871,92566,3.0,MO
162,2018,Jul,63.5,61.6,3043321,2952342,90979,3.0,MO
163,2018,Aug,63.4,61.6,3041022,2950482,90540,3.0,MO
164,2018,Sep,63.4,61.5,3040688,2949408,91280,3.0,MO
165,2018,Oct,63.4,61.5,3042835,2949912,92923,3.1,MO
166,2018,Nov,63.5,61.5,3046860,2951947,94913,3.1,MO
167,2018,Dec,63.6,61.5,3051599,2955001,96598,3.2,MO
168,2019,Jan,63.6,61.6,3055756,2958450,97306,3.2,MO
169,2019,Feb,63.7,61.7,3058461,2961950,96511,3.2,MO
170,2019,Mar,63.7,61.7,3059749,2965324,94425,3.1,MO
171,2019,Apr,63.7,61.8,3060564,2968878,91686,3.0,MO
172,2019,May,63.7,61.8,3061774,2972411,89363,2.9,MO
173,2019,Jun,63.7,61.9,3064416,2975778,88638,2.9,MO
174,2019,Jul,63.8,61.9,3068974,2978918,90056,2.9,MO
175,2019,Aug,63.9,61.9,3075116,2981856,93260,3.0,MO
176,2019,Sep,64.0,62.0,3082034,2985197,96837,3.1,MO
177,2019,Oct,64.1,62.0,3088206,2988543,99663,3.2,MO
178,2019,Nov,64.1,62.0,3092198,2991310,100888,3.3,MO
179,2019,Dec,64.1,62.0,3092577,2991922,100655,3.3,MO
180,2020,Jan,64.0,62.0,3090121,2989677,100444,3.3,MO
181,2020,Feb,64.0,61.8,3087412,2985019,102393,3.3,MO
182,2020,Mar,64.0,61.7,3087510,2980223,107287,3.5,MO
183,2020,Apr,60.7,53.9,2929672,2602292,327380,11.2,MO
184,2020,May,59.5,54.0,2873545,2609270,264275,9.2,MO
185,2020,Jun,61.5,56.8,2972111,2742090,230021,7.7,MO
186,2020,Jul,63.8,59.4,3083772,2867609,216163,7.0,MO
187,2020,Aug,63.6,59.6,3074580,2878044,196536,6.4,MO
188,2020,Sep,63.5,59.7,3071174,2887628,183546,6.0,MO
189,2020,Oct,63.3,59.8,3061264,2893155,168109,5.5,MO
190,2020,Nov,63.2,59.9,3057663,2896684,160979,5.3,MO
191,2020,Dec,63.1,59.9,3055656,2898598,157058,5.1,MO
192,2021,Jan,63.1,59.9,3054179,2901666,152513,5.0,MO
193,2021,Feb,63.1,60.0,3056002,2905783,150219,4.9,MO
194,2021,Mar,63.1,60.1,3058949,2911306,147643,4.8,MO
195,2021,Apr,63.2,60.2,3060358,2916274,144084,4.7,MO
196,2021,May,63.1,60.2,3059440,2920460,138980,4.5,MO
197,2021,Jun,63.1,60.3,3059568,2924576,134992,4.4,MO
198,2021,Jul,63.0,60.3,3059425,2928832,130593,4.3,MO
199,2021,Aug,63.0,60.4,3060882,2934059,126823,4.1,MO
200,2021,Sep,63.0,60.5,3062759,2939226,123533,4.0,MO
201,2021,Oct,63.1,60.6,3066928,2945351,121577,4.0,MO
202,2021,Nov,63.0,60.5,3066846,2946335,120511,3.9,MO
203,2021,Dec,63.0,60.5,3066275,2946150,120125,3.9,MO
204,2022,Jan,63.1,60.7,3075764,2957720,118044,3.8,MO
205,2022,Feb,63.2,60.9,3080111,2965823,114288,3.7,MO
206,2022,Mar,63.3,61.1,3087818,2977825,109993,3.6,MO
207,2022,Apr,63.4,61.3,3091654,2988049,103605,3.4,MO
208,2022,May,63.3,61.3,3087946,2991485,96461,3.1,MO
209,2022,Jun,63.0,61.2,3074357,2989446,84911,2.8,MO
210,2022,Jul,62.5,60.9,3055883,2977960,77923,2.5,MO
211,2022,Aug,62.4,60.8,3051614,2975458,76156,2.5,MO
212,2022,Sep,62.4,60.9,3053598,2979064,74534,2.4,MO
213,2022,Oct,62.4,60.8,3055830,2976962,78868,2.6,MO
214,2022,Nov,62.5,60.8,3063020,2980020,83000,2.7,MO
0,2005,Jan,72.3,69.8,354783,342697,12086,3.4,ND
1,2005,Feb,72.3,69.9,355050,342924,12126,3.4,ND
2,2005,Mar,72.4,69.9,355342,343219,12123,3.4,ND
3,2005,Apr,72.4,70.0,355685,343627,12058,3.4,ND
4,2005,May,72.5,70.1,356096,344144,11952,3.4,ND
5,2005,Jun,72.5,70.1,356490,344643,11847,3.3,ND
6,2005,Jul,72.6,70.2,356804,345038,11766,3.3,ND
7,2005,Aug,72.6,70.2,357007,345323,11684,3.3,ND
8,2005,Sep,72.6,70.2,357126,345520,11606,3.2,ND
9,2005,Oct,72.5,70.2,357237,345720,11517,3.2,ND
10,2005,Nov,72.5,70.2,357460,346030,11430,3.2,ND
11,2005,Dec,72.6,70.3,357871,346528,11343,3.2,ND
12,2006,Jan,72.7,70.4,358494,347249,11245,3.1,ND
13,2006,Feb,72.8,70.6,359250,348085,11165,3.1,ND
14,2006,Mar,73.0,70.7,360031,348880,11151,3.1,ND
15,2006,Apr,73.1,70.8,360738,349549,11189,3.1,ND
16,2006,May,73.2,70.9,361347,350121,11226,3.1,ND
17,2006,Jun,73.3,71.0,361937,350670,11267,3.1,ND
18,2006,Jul,73.4,71.1,362649,351322,11327,3.1,ND
19,2006,Aug,73.6,71.3,363565,352156,11409,3.1,ND
20,2006,Sep,73.8,71.4,364623,353145,11478,3.1,ND
21,2006,Oct,73.9,71.6,365696,354220,11476,3.1,ND
22,2006,Nov,74.1,71.8,366612,355207,11405,3.1,ND
23,2006,Dec,74.2,71.9,367189,355898,11291,3.1,ND
24,2007,Jan,74.2,72.0,367404,356225,11179,3.0,ND
25,2007,Feb,74.2,72.0,367395,356305,11090,3.0,ND
26,2007,Mar,74.2,71.9,367245,356219,11026,3.0,ND
27,2007,Apr,74.1,71.9,367044,356032,11012,3.0,ND
28,2007,May,74.1,71.8,366908,355846,11062,3.0,ND
29,2007,Jun,74.0,71.8,366881,355769,11112,3.0,ND
30,2007,Jul,74.0,71.8,366973,355826,11147,3.0,ND
31,2007,Aug,74.0,71.8,367248,356046,11202,3.1,ND
32,2007,Sep,74.1,71.8,367720,356480,11240,3.1,ND
33,2007,Oct,74.2,71.9,368303,357073,11230,3.0,ND
34,2007,Nov,74.2,72.0,368915,357796,11119,3.0,ND
35,2007,Dec,74.3,72.1,369539,358627,10912,3.0,ND
36,2008,Jan,74.4,72.3,370084,359404,10680,2.9,ND
37,2008,Feb,74.5,72.4,370543,360026,10517,2.8,ND
38,2008,Mar,74.5,72.4,371008,360494,10514,2.8,ND
39,2008,Apr,74.6,72.4,371511,360812,10699,2.9,ND
40,2008,May,74.7,72.4,372002,360972,11030,3.0,ND
41,2008,Jun,74.7,72.4,372451,361028,11423,3.1,ND
42,2008,Jul,74.7,72.4,372778,361053,11725,3.1,ND
43,2008,Aug,74.7,72.3,372873,361008,11865,3.2,ND
44,2008,Sep,74.6,72.2,372754,360773,11981,3.2,ND
45,2008,Oct,74.5,72.0,372521,360295,12226,3.3,ND
46,2008,Nov,74.3,71.8,372157,359493,12664,3.4,ND
47,2008,Dec,74.2,71.5,371636,358367,13269,3.6,ND
48,2009,Jan,74.0,71.2,371028,357087,13941,3.8,ND
49,2009,Feb,73.8,70.9,370446,355913,14533,3.9,ND
50,2009,Mar,73.7,70.7,370006,355112,14894,4.0,ND
51,2009,Apr,73.6,70.6,369825,354854,14971,4.0,ND
52,2009,May,73.5,70.6,369861,355043,14818,4.0,ND
53,2009,Jun,73.5,70.6,370025,355453,14572,3.9,ND
54,2009,Jul,73.5,70.6,370213,355821,14392,3.9,ND
55,2009,Aug,73.4,70.6,370339,356001,14338,3.9,ND
56,2009,Sep,73.4,70.5,370388,356037,14351,3.9,ND
57,2009,Oct,73.3,70.4,370429,356015,14414,3.9,ND
58,2009,Nov,73.3,70.4,370759,356229,14530,3.9,ND
59,2009,Dec,73.4,70.5,371637,356990,14647,3.9,ND
60,2010,Jan,73.6,70.7,373035,358345,14690,3.9,ND
61,2010,Feb,73.9,71.0,374693,360056,14637,3.9,ND
62,2010,Mar,74.1,71.3,376324,361821,14503,3.9,ND
63,2010,Apr,72.2,69.5,377707,363391,14316,3.8,ND
64,2010,May,72.3,69.6,378740,364640,14100,3.7,ND
65,2010,Jun,72.4,69.7,379417,365524,13893,3.7,ND
66,2010,Jul,72.4,69.8,379868,366120,13748,3.6,ND
67,2010,Aug,72.4,69.8,380313,366628,13685,3.6,ND
68,2010,Sep,72.4,69.8,380880,367203,13677,3.6,ND
69,2010,Oct,72.4,69.8,381637,367989,13648,3.6,ND
70,2010,Nov,72.5,69.9,382500,368950,13550,3.5,ND
71,2010,Dec,72.5,70.0,383322,369920,13402,3.5,ND
72,2011,Jan,72.6,70.1,384036,370786,13250,3.5,ND
73,2011,Feb,72.6,70.1,384570,371452,13118,3.4,ND
74,2011,Mar,72.6,70.1,384923,371894,13029,3.4,ND
75,2011,Apr,72.5,70.1,385203,372188,13015,3.4,ND
76,2011,May,72.5,70.1,385579,372496,13083,3.4,ND
77,2011,Jun,72.5,70.1,386171,372985,13186,3.4,ND
78,2011,Jul,72.6,70.1,387021,373776,13245,3.4,ND
79,2011,Aug,72.6,70.2,388085,374881,13204,3.4,ND
80,2011,Sep,72.7,70.3,389260,376216,13044,3.4,ND
81,2011,Oct,72.8,70.4,390370,377584,12786,3.3,ND
82,2011,Nov,72.8,70.5,391260,378801,12459,3.2,ND
83,2011,Dec,72.8,70.6,391899,379791,12108,3.1,ND
84,2012,Jan,72.8,70.6,392396,380609,11787,3.0,ND
85,2012,Feb,72.8,70.6,392930,381373,11557,2.9,ND
86,2012,Mar,72.8,70.7,393520,382069,11451,2.9,ND
87,2012,Apr,72.8,70.6,394095,382664,11431,2.9,ND
88,2012,May,72.7,70.6,394721,383260,11461,2.9,ND
89,2012,Jun,72.7,70.6,395387,383880,11507,2.9,ND
90,2012,Jul,72.7,70.6,396002,384458,11544,2.9,ND
91,2012,Aug,72.6,70.5,396531,384938,11593,2.9,ND
92,2012,Sep,72.5,70.4,397001,385324,11677,2.9,ND
93,2012,Oct,72.5,70.3,397453,385682,11771,3.0,ND
94,2012,Nov,72.4,70.2,397899,386044,11855,3.0,ND
95,2012,Dec,72.3,70.1,398367,386448,11919,3.0,ND
96,2013,Jan,72.2,70.1,398890,386941,11949,3.0,ND
97,2013,Feb,72.2,70.0,399469,387536,11933,3.0,ND
98,2013,Mar,72.1,70.0,400112,388244,11868,3.0,ND
99,2013,Apr,72.1,70.0,400851,389070,11781,2.9,ND
100,2013,May,72.1,70.0,401517,389822,11695,2.9,ND
101,2013,Jun,72.0,69.9,402024,390402,11622,2.9,ND
102,2013,Jul,71.9,69.8,402383,390809,11574,2.9,ND
103,2013,Aug,71.8,69.7,402531,391018,11513,2.9,ND
104,2013,Sep,71.7,69.6,402511,391090,11421,2.8,ND
105,2013,Oct,71.5,69.5,402486,391157,11329,2.8,ND
106,2013,Nov,71.5,69.5,402613,391386,11227,2.8,ND
107,2013,Dec,71.4,69.4,402945,391849,11096,2.8,ND
108,2014,Jan,71.4,69.4,403489,392552,10937,2.7,ND
109,2014,Feb,71.4,69.5,404290,393523,10767,2.7,ND
110,2014,Mar,71.5,69.6,405352,394726,10626,2.6,ND
111,2014,Apr,71.6,69.7,406510,395968,10542,2.6,ND
112,2014,May,71.7,69.8,407697,397170,10527,2.6,ND
113,2014,Jun,71.8,69.9,408963,398374,10589,2.6,ND
114,2014,Jul,71.9,70.0,410272,399572,10700,2.6,ND
115,2014,Aug,72.0,70.1,411625,400807,10818,2.6,ND
116,2014,Sep,72.1,70.2,412889,401994,10895,2.6,ND
117,2014,Oct,72.1,70.2,413859,402968,10891,2.6,ND
118,2014,Nov,72.1,70.2,414357,403536,10821,2.6,ND
119,2014,Dec,72.0,70.1,414356,403589,10767,2.6,ND
120,2015,Jan,71.8,69.9,413890,403094,10796,2.6,ND
121,2015,Feb,71.6,69.7,413044,402107,10937,2.6,ND
122,2015,Mar,71.3,69.3,412032,400873,11159,2.7,ND
123,2015,Apr,71.0,69.0,411096,399699,11397,2.8,ND
124,2015,May,70.8,68.8,410351,398775,11576,2.8,ND
125,2015,Jun,70.5,68.5,409780,398126,11654,2.8,ND
126,2015,Jul,70.4,68.4,409442,397805,11637,2.8,ND
127,2015,Aug,70.4,68.4,409372,397788,11584,2.8,ND
128,2015,Sep,70.4,68.4,409549,397992,11557,2.8,ND
129,2015,Oct,70.5,68.5,409944,398304,11640,2.8,ND
130,2015,Nov,70.6,68.5,410486,398595,11891,2.9,ND
131,2015,Dec,70.7,68.6,411033,398772,12261,3.0,ND
132,2016,Jan,70.8,68.6,411466,398799,12667,3.1,ND
133,2016,Feb,70.8,68.6,411741,398708,13033,3.2,ND
134,2016,Mar,70.9,68.6,411888,398605,13283,3.2,ND
135,2016,Apr,70.9,68.6,412015,398635,13380,3.2,ND
136,2016,May,70.9,68.6,412193,398875,13318,3.2,ND
137,2016,Jun,71.0,68.7,412394,399269,13125,3.2,ND
138,2016,Jul,71.0,68.8,412494,399631,12863,3.1,ND
139,2016,Aug,71.0,68.8,412382,399770,12612,3.1,ND
140,2016,Sep,70.9,68.8,412070,399634,12436,3.0,ND
141,2016,Oct,70.8,68.7,411605,399286,12319,3.0,ND
142,2016,Nov,70.8,68.7,411185,398987,12198,3.0,ND
143,2016,Dec,70.7,68.7,411029,398992,12037,2.9,ND
144,2017,Jan,70.8,68.8,415857,403954,11903,2.9,ND
145,2017,Feb,70.9,68.9,416427,404812,11615,2.8,ND
146,2017,Mar,71.0,69.1,416974,405729,11245,2.7,ND
147,2017,Apr,71.0,69.2,417282,406414,10868,2.6,ND
148,2017,May,71.0,69.2,417252,406697,10555,2.5,ND
149,2017,Jun,71.0,69.2,416868,406504,10364,2.5,ND
150,2017,Jul,70.8,69.1,416228,405903,10325,2.5,ND
151,2017,Aug,70.7,68.9,415469,405078,10391,2.5,ND
152,2017,Sep,70.5,68.7,414730,404220,10510,2.5,ND
153,2017,Oct,70.4,68.6,414181,403543,10638,2.6,ND
154,2017,Nov,70.3,68.5,413872,403097,10775,2.6,ND
155,2017,Dec,70.3,68.4,413778,402903,10875,2.6,ND
156,2018,Jan,70.3,68.4,413862,402974,10888,2.6,ND
157,2018,Feb,70.3,68.5,414046,403274,10772,2.6,ND
158,2018,Mar,70.3,68.5,414152,403638,10514,2.5,ND
159,2018,Apr,70.2,68.5,413934,403790,10144,2.5,ND
160,2018,May,70.1,68.5,413311,403552,9759,2.4,ND
161,2018,Jun,69.9,68.3,412461,403021,9440,2.3,ND
162,2018,Jul,69.8,68.2,411616,402404,9212,2.2,ND
163,2018,Aug,69.6,68.1,411069,401953,9116,2.2,ND
164,2018,Sep,69.6,68.0,411005,401849,9156,2.2,ND
165,2018,Oct,69.6,68.1,411451,402173,9278,2.3,ND
166,2018,Nov,69.8,68.2,412347,402917,9430,2.3,ND
167,2018,Dec,69.9,68.3,413523,403964,9559,2.3,ND
168,2019,Jan,70.1,68.5,414641,405030,9611,2.3,ND
169,2019,Feb,70.2,68.6,415401,405873,9528,2.3,ND
170,2019,Mar,70.2,68.7,415701,406393,9308,2.2,ND
171,2019,Apr,70.2,68.7,415645,406648,8997,2.2,ND
172,2019,May,70.1,68.7,415342,406663,8679,2.1,ND
173,2019,Jun,70.0,68.6,414977,406516,8461,2.0,ND
174,2019,Jul,70.0,68.5,414727,406334,8393,2.0,ND
175,2019,Aug,69.9,68.5,414660,406214,8446,2.0,ND
176,2019,Sep,69.9,68.5,414799,406288,8511,2.1,ND
177,2019,Oct,69.9,68.5,414998,406466,8532,2.1,ND
178,2019,Nov,69.8,68.4,414929,406501,8428,2.0,ND
179,2019,Dec,69.7,68.3,414418,406077,8341,2.0,ND
180,2020,Jan,69.6,68.2,413752,405201,8551,2.1,ND
181,2020,Feb,69.5,68.0,413351,404089,9262,2.2,ND
182,2020,Mar,69.6,67.8,413691,403190,10501,2.5,ND
183,2020,Apr,69.8,64.0,415388,380877,34511,8.3,ND
184,2020,May,69.1,64.2,410771,382000,28771,7.0,ND
185,2020,Jun,68.9,64.5,409594,383544,26050,6.4,ND
186,2020,Jul,69.1,64.9,411133,385728,25405,6.2,ND
187,2020,Aug,69.2,65.1,411369,387368,24001,5.8,ND
188,2020,Sep,69.2,65.3,411512,388452,23060,5.6,ND
189,2020,Oct,69.0,65.4,410189,388564,21625,5.3,ND
190,2020,Nov,68.8,65.3,409197,388323,20874,5.1,ND
191,2020,Dec,68.7,65.3,408184,387978,20206,5.0,ND
192,2021,Jan,68.6,65.3,407188,388005,19183,4.7,ND
193,2021,Feb,68.5,65.4,406672,388397,18275,4.5,ND
194,2021,Mar,68.5,65.6,406489,389151,17338,4.3,ND
195,2021,Apr,68.5,65.7,406173,389799,16374,4.0,ND
196,2021,May,68.4,65.8,405568,390192,15376,3.8,ND
197,2021,Jun,68.3,65.9,405150,390545,14605,3.6,ND
198,2021,Jul,68.3,65.9,404870,390972,13898,3.4,ND
199,2021,Aug,68.3,66.1,405037,391649,13388,3.3,ND
200,2021,Sep,68.4,66.2,405435,392410,13025,3.2,ND
201,2021,Oct,68.5,66.3,406219,393391,12828,3.2,ND
202,2021,Nov,68.5,66.4,406341,393574,12767,3.1,ND
203,2021,Dec,68.5,66.4,406282,393547,12735,3.1,ND
204,2022,Jan,68.8,66.7,408106,395636,12470,3.1,ND
205,2022,Feb,69.1,67.0,409405,397388,12017,2.9,ND
206,2022,Mar,69.2,67.2,409961,398246,11715,2.9,ND
207,2022,Apr,69.3,67.4,410859,399533,11326,2.8,ND
208,2022,May,69.3,67.5,410893,400135,10758,2.6,ND
209,2022,Jun,69.3,67.6,410553,400418,10135,2.5,ND
210,2022,Jul,69.1,67.5,409789,400202,9587,2.3,ND
211,2022,Aug,69.0,67.4,408906,399629,9277,2.3,ND
212,2022,Sep,68.8,67.2,407719,398610,9109,2.2,ND
213,2022,Oct,68.7,67.1,407131,397896,9235,2.3,ND
214,2022,Nov,68.6,67.0,406667,397409,9258,2.3,ND
0,2005,Jan,65.7,61.3,1840535,1719030,121505,6.6,OA
1,2005,Feb,65.6,61.4,1841539,1722403,119136,6.5,OA
2,2005,Mar,65.6,61.4,1843099,1725739,117360,6.4,OA
3,2005,Apr,65.6,61.5,1845150,1729019,116131,6.3,OA
4,2005,May,65.6,61.5,1847512,1732227,115285,6.2,OA
5,2005,Jun,65.6,61.5,1849614,1735012,114602,6.2,OA
6,2005,Jul,65.6,61.5,1851120,1737093,114027,6.2,OA
7,2005,Aug,65.5,61.5,1852083,1738689,113394,6.1,OA
8,2005,Sep,65.4,61.4,1852864,1740376,112488,6.1,OA
9,2005,Oct,65.3,61.4,1853654,1742628,111026,6.0,OA
10,2005,Nov,65.2,61.4,1854667,1745572,109095,5.9,OA
11,2005,Dec,65.1,61.4,1856074,1749282,106792,5.8,OA
12,2006,Jan,65.1,61.5,1858333,1753954,104379,5.6,OA
13,2006,Feb,65.1,61.6,1861625,1759373,102252,5.5,OA
14,2006,Mar,65.2,61.7,1865808,1765028,100780,5.4,OA
15,2006,Apr,65.3,61.8,1870498,1770303,100195,5.4,OA
16,2006,May,65.3,61.8,1875141,1774854,100287,5.3,OA
17,2006,Jun,65.4,61.9,1879552,1778796,100756,5.4,OA
18,2006,Jul,65.5,61.9,1883930,1782598,101332,5.4,OA
19,2006,Aug,65.5,62.0,1888427,1786546,101881,5.4,OA
20,2006,Sep,65.6,62.0,1892988,1790709,102279,5.4,OA
21,2006,Oct,65.6,62.1,1897606,1795512,102094,5.4,OA
22,2006,Nov,65.7,62.2,1901918,1800823,101095,5.3,OA
23,2006,Dec,65.7,62.3,1905040,1805631,99409,5.2,OA
24,2007,Jan,65.7,62.3,1906671,1809169,97502,5.1,OA
25,2007,Feb,65.6,62.3,1906967,1811075,95892,5.0,OA
26,2007,Mar,65.5,62.2,1906174,1811295,94879,5.0,OA
27,2007,Apr,65.3,62.1,1905062,1810393,94669,5.0,OA
28,2007,May,65.2,62.0,1904550,1809031,95519,5.0,OA
29,2007,Jun,65.2,61.8,1905140,1807945,97195,5.1,OA
30,2007,Jul,65.1,61.7,1907026,1807857,99169,5.2,OA
31,2007,Aug,65.1,61.7,1910361,1809306,101055,5.3,OA
32,2007,Sep,65.2,61.7,1914597,1812240,102357,5.3,OA
33,2007,Oct,65.3,61.8,1918769,1815958,102811,5.4,OA
34,2007,Nov,65.3,61.8,1922205,1819994,102211,5.3,OA
35,2007,Dec,65.3,61.9,1924688,1824021,100667,5.2,OA
36,2008,Jan,65.3,61.9,1925863,1827073,98790,5.1,OA
37,2008,Feb,65.2,61.9,1926271,1828799,97472,5.1,OA
38,2008,Mar,65.2,61.9,1927307,1829599,97708,5.1,OA
39,2008,Apr,65.2,61.8,1930010,1829951,100059,5.2,OA
40,2008,May,65.3,61.7,1935049,1830610,104439,5.4,OA
41,2008,Jun,65.4,61.7,1942229,1831696,110533,5.7,OA
42,2008,Jul,65.6,61.6,1950173,1832417,117756,6.0,OA
43,2008,Aug,65.8,61.5,1957311,1831635,125676,6.4,OA
44,2008,Sep,65.9,61.4,1962925,1828177,134748,6.9,OA
45,2008,Oct,65.9,61.0,1966958,1821021,145937,7.4,OA
46,2008,Nov,66.0,60.6,1969619,1809879,159740,8.1,OA
47,2008,Dec,66.0,60.1,1971578,1795993,175585,8.9,OA
48,2009,Jan,66.0,59.5,1973386,1781451,191935,9.7,OA
49,2009,Feb,66.0,59.1,1975379,1768747,206632,10.5,OA
50,2009,Mar,66.0,58.7,1977117,1759644,217473,11.0,OA
51,2009,Apr,65.9,58.5,1977826,1754553,223273,11.3,OA
52,2009,May,65.8,58.4,1976717,1752493,224224,11.3,OA
53,2009,Jun,65.7,58.3,1973627,1752128,221499,11.2,OA
54,2009,Jul,65.4,58.2,1969041,1752029,217012,11.0,OA
55,2009,Aug,65.2,58.1,1963985,1751276,212709,10.8,OA
56,2009,Sep,65.0,58.0,1959776,1750074,209702,10.7,OA
57,2009,Oct,64.8,57.9,1957509,1749082,208427,10.6,OA
58,2009,Nov,64.8,57.9,1958343,1749369,208974,10.7,OA
59,2009,Dec,64.9,57.9,1962640,1751681,210959,10.7,OA
60,2010,Jan,65.1,58.0,1969690,1756262,213428,10.8,OA
61,2010,Feb,65.3,58.2,1977638,1762239,215399,10.9,OA
62,2010,Mar,65.5,58.3,1984778,1768457,216321,10.9,OA
63,2010,Apr,65.8,58.7,1990068,1773965,216103,10.9,OA
64,2010,May,65.8,58.7,1992953,1778073,214880,10.8,OA
65,2010,Jun,65.8,58.8,1994048,1780620,213428,10.7,OA
66,2010,Jul,65.8,58.8,1994552,1781970,212582,10.7,OA
67,2010,Aug,65.7,58.7,1995295,1782838,212457,10.6,OA
68,2010,Sep,65.7,58.7,1996450,1783866,212584,10.6,OA
69,2010,Oct,65.7,58.7,1998014,1786006,212008,10.6,OA
70,2010,Nov,65.6,58.8,1999456,1789598,209858,10.5,OA
71,2010,Dec,65.6,58.8,2000082,1794045,206037,10.3,OA
72,2011,Jan,65.5,58.9,1999833,1798493,201340,10.1,OA
73,2011,Feb,65.4,59.0,1998756,1801913,196843,9.8,OA
74,2011,Mar,65.3,59.0,1997052,1803636,193416,9.7,OA
75,2011,Apr,65.2,59.0,1995371,1803756,191615,9.6,OA
76,2011,May,65.1,58.9,1994438,1802840,191598,9.6,OA
77,2011,Jun,65.1,58.8,1994170,1801687,192483,9.7,OA
78,2011,Jul,65.0,58.7,1994525,1801501,193024,9.7,OA
79,2011,Aug,65.0,58.7,1995328,1802792,192536,9.6,OA
80,2011,Sep,64.9,58.7,1995988,1805189,190799,9.6,OA
81,2011,Oct,64.9,58.8,1996000,1807834,188166,9.4,OA
82,2011,Nov,64.8,58.8,1994860,1809617,185243,9.3,OA
83,2011,Dec,64.6,58.7,1992429,1809926,182503,9.2,OA
84,2012,Jan,64.5,58.6,1988854,1808723,180131,9.1,OA
85,2012,Feb,64.3,58.5,1984596,1806253,178343,9.0,OA
86,2012,Mar,64.1,58.4,1980071,1802745,177326,9.0,OA
87,2012,Apr,63.9,58.2,1975219,1798555,176664,8.9,OA
88,2012,May,63.7,58.0,1970481,1794592,175889,8.9,OA
89,2012,Jun,63.5,57.9,1966171,1791433,174738,8.9,OA
90,2012,Jul,63.3,57.7,1962128,1789026,173102,8.8,OA
91,2012,Aug,63.1,57.6,1958250,1786947,171303,8.7,OA
92,2012,Sep,63.0,57.5,1954589,1784773,169816,8.7,OA
93,2012,Oct,62.8,57.4,1950570,1782030,168540,8.6,OA
94,2012,Nov,62.6,57.2,1945807,1778641,167166,8.6,OA
95,2012,Dec,62.4,57.0,1940426,1775016,165410,8.5,OA
96,2013,Jan,62.1,56.9,1934879,1771649,163230,8.4,OA
97,2013,Feb,62.0,56.8,1929899,1769268,160631,8.3,OA
98,2013,Mar,61.8,56.7,1926144,1768464,157680,8.2,OA
99,2013,Apr,61.7,56.7,1924158,1769494,154664,8.0,OA
100,2013,May,61.6,56.8,1923376,1771464,151912,7.9,OA
101,2013,Jun,61.6,56.8,1923051,1773458,149593,7.8,OA
102,2013,Jul,61.5,56.8,1922652,1775086,147566,7.7,OA
103,2013,Aug,61.4,56.8,1921985,1776755,145230,7.6,OA
104,2013,Sep,61.3,56.8,1921524,1778975,142549,7.4,OA
105,2013,Oct,61.3,56.8,1922159,1781810,140349,7.3,OA
106,2013,Nov,61.3,56.9,1924468,1785385,139083,7.2,OA
107,2013,Dec,61.4,56.9,1928211,1789567,138644,7.2,OA
108,2014,Jan,61.4,57.0,1932624,1794235,138389,7.2,OA
109,2014,Feb,61.5,57.1,1936905,1799250,137655,7.1,OA
110,2014,Mar,61.6,57.3,1940643,1804298,136345,7.0,OA
111,2014,Apr,61.6,57.3,1943538,1808969,134569,6.9,OA
112,2014,May,61.6,57.4,1945984,1813583,132401,6.8,OA
113,2014,Jun,61.7,57.5,1948765,1818552,130213,6.7,OA
114,2014,Jul,61.7,57.6,1951938,1823499,128439,6.6,OA
115,2014,Aug,61.7,57.7,1955313,1828180,127133,6.5,OA
116,2014,Sep,61.7,57.7,1958331,1832536,125795,6.4,OA
117,2014,Oct,61.7,57.8,1960334,1836625,123709,6.3,OA
118,2014,Nov,61.6,57.8,1960742,1840037,120705,6.2,OA
119,2014,Dec,61.5,57.8,1960168,1842745,117423,6.0,OA
120,2015,Jan,61.4,57.8,1959718,1845083,114635,5.8,OA
121,2015,Feb,61.4,57.8,1960323,1847488,112835,5.8,OA
122,2015,Mar,61.4,57.9,1962380,1850584,111796,5.7,OA
123,2015,Apr,61.4,57.9,1965819,1854638,111181,5.7,OA
124,2015,May,61.5,58.0,1970139,1859558,110581,5.6,OA
125,2015,Jun,61.5,58.1,1974615,1865067,109548,5.5,OA
126,2015,Jul,61.6,58.2,1979176,1871082,108094,5.5,OA
127,2015,Aug,61.6,58.3,1983912,1877482,106430,5.4,OA
128,2015,Sep,61.6,58.4,1989069,1884395,104674,5.3,OA
129,2015,Oct,61.7,58.5,1995491,1892430,103061,5.2,OA
130,2015,Nov,61.9,58.7,2003622,1901807,101815,5.1,OA
131,2015,Dec,62.0,58.9,2012522,1911765,100757,5.0,OA
132,2016,Jan,62.2,59.1,2020991,1921114,99877,4.9,OA
133,2016,Feb,62.3,59.3,2028181,1928738,99443,4.9,OA
134,2016,Mar,62.4,59.3,2033640,1934161,99479,4.9,OA
135,2016,Apr,62.4,59.3,2037655,1937802,99853,4.9,OA
136,2016,May,62.4,59.3,2040822,1940533,100289,4.9,OA
137,2016,Jun,62.4,59.3,2043662,1943278,100384,4.9,OA
138,2016,Jul,62.3,59.3,2046599,1946984,99615,4.9,OA
139,2016,Aug,62.3,59.3,2049413,1951419,97994,4.8,OA
140,2016,Sep,62.3,59.4,2051528,1955705,95823,4.7,OA
141,2016,Oct,62.2,59.4,2052451,1959271,93180,4.5,OA
142,2016,Nov,62.2,59.4,2052819,1962568,90251,4.4,OA
143,2016,Dec,62.1,59.5,2053931,1966524,87407,4.3,OA
144,2017,Jan,62.1,59.5,2051997,1967522,84475,4.1,OA
145,2017,Feb,62.1,59.7,2056892,1974410,82482,4.0,OA
146,2017,Mar,62.3,59.8,2063722,1982317,81405,3.9,OA
147,2017,Apr,62.4,60.0,2071449,1990080,81369,3.9,OA
148,2017,May,62.6,60.1,2078660,1996510,82150,4.0,OA
149,2017,Jun,62.6,60.1,2083955,2000509,83446,4.0,OA
150,2017,Jul,62.6,60.1,2086668,2001713,84955,4.1,OA
151,2017,Aug,62.6,60.0,2087018,2000873,86145,4.1,OA
152,2017,Sep,62.5,59.9,2086104,1999344,86760,4.2,OA
153,2017,Oct,62.4,59.8,2084732,1997970,86762,4.2,OA
154,2017,Nov,62.3,59.7,2083101,1996852,86249,4.1,OA
155,2017,Dec,62.2,59.6,2081495,1996148,85347,4.1,OA
156,2018,Jan,62.1,59.6,2080424,1996142,84282,4.1,OA
157,2018,Feb,62.0,59.6,2080153,1996923,83230,4.0,OA
158,2018,Mar,62.0,59.5,2080226,1998044,82182,4.0,OA
159,2018,Apr,61.9,59.5,2079857,1998755,81102,3.9,OA
160,2018,May,61.8,59.5,2078801,1998452,80349,3.9,OA
161,2018,Jun,61.8,59.4,2077632,1997378,80254,3.9,OA
162,2018,Jul,61.7,59.3,2076599,1995609,80990,3.9,OA
163,2018,Aug,61.6,59.1,2076632,1994018,82614,4.0,OA
164,2018,Sep,61.6,59.1,2078402,1993590,84812,4.1,OA
165,2018,Oct,61.6,59.1,2081707,1994809,86898,4.2,OA
166,2018,Nov,61.7,59.1,2085991,1997731,88260,4.2,OA
167,2018,Dec,61.8,59.2,2090281,2001899,88382,4.2,OA
168,2019,Jan,61.8,59.2,2093302,2006191,87111,4.2,OA
169,2019,Feb,61.8,59.3,2094550,2009795,84755,4.0,OA
170,2019,Mar,61.8,59.3,2094679,2012489,82190,3.9,OA
171,2019,Apr,61.7,59.4,2094569,2014442,80127,3.8,OA
172,2019,May,61.7,59.3,2094553,2015725,78828,3.8,OA
173,2019,Jun,61.6,59.3,2094855,2016713,78142,3.7,OA
174,2019,Jul,61.6,59.3,2095416,2017786,77630,3.7,OA
175,2019,Aug,61.5,59.3,2095630,2018865,76765,3.7,OA
176,2019,Sep,61.4,59.2,2095313,2020176,75137,3.6,OA
177,2019,Oct,61.4,59.2,2095119,2021865,73254,3.5,OA
178,2019,Nov,61.3,59.2,2094978,2023277,71701,3.4,OA
179,2019,Dec,61.2,59.2,2093793,2022866,70927,3.4,OA
180,2020,Jan,61.1,59.0,2091160,2020092,71068,3.4,OA
181,2020,Feb,61.0,58.9,2086983,2015218,71765,3.4,OA
182,2020,Mar,60.8,58.7,2082016,2009882,72134,3.5,OA
183,2020,Apr,59.2,51.3,2028482,1759680,268802,13.3,OA
184,2020,May,61.5,54.0,2108250,1850939,257311,12.2,OA
185,2020,Jun,61.4,55.0,2105645,1885544,220101,10.5,OA
186,2020,Jul,61.7,55.9,2119317,1918495,200822,9.5,OA
187,2020,Aug,61.6,56.6,2116178,1945267,170911,8.1,OA
188,2020,Sep,61.9,57.2,2126399,1965990,160409,7.5,OA
189,2020,Oct,61.8,57.5,2123899,1978535,145364,6.8,OA
190,2020,Nov,61.8,57.7,2126407,1986027,140380,6.6,OA
191,2020,Dec,62.0,57.9,2132173,1991479,140694,6.6,OA
192,2021,Jan,62.0,58.0,2132790,1997279,135511,6.4,OA
193,2021,Feb,62.1,58.2,2137702,2004641,133061,6.2,OA
194,2021,Mar,62.2,58.5,2143183,2013317,129866,6.1,OA
195,2021,Apr,62.4,58.7,2148432,2021599,126833,5.9,OA
196,2021,May,62.3,58.9,2147616,2028171,119445,5.6,OA
197,2021,Jun,62.3,59.0,2149652,2032584,117068,5.4,OA
198,2021,Jul,62.2,59.0,2146514,2037215,109299,5.1,OA
199,2021,Aug,62.2,59.2,2147670,2043151,104519,4.9,OA
200,2021,Sep,62.2,59.4,2148586,2051284,97302,4.5,OA
201,2021,Oct,62.3,59.6,2153888,2059323,94565,4.4,OA
202,2021,Nov,62.3,59.6,2153754,2062462,91292,4.2,OA
203,2021,Dec,62.2,59.6,2153595,2062891,90704,4.2,OA
204,2022,Jan,62.6,59.9,2166854,2074950,91904,4.2,OA
205,2022,Feb,62.8,60.2,2174003,2087129,86874,4.0,OA
206,2022,Mar,63.0,60.6,2183443,2101457,81986,3.8,OA
207,2022,Apr,63.3,60.9,2193742,2112980,80762,3.7,OA
208,2022,May,63.5,61.2,2202391,2124241,78150,3.5,OA
209,2022,Jun,63.5,61.3,2205177,2127854,77323,3.5,OA
210,2022,Jul,63.5,61.3,2205196,2128649,76547,3.5,OA
211,2022,Aug,63.5,61.1,2206930,2124953,81977,3.7,OA
212,2022,Sep,63.3,60.9,2202611,2118964,83647,3.8,OA
213,2022,Oct,63.2,60.7,2201426,2111589,89837,4.1,OA
214,2022,Nov,63.1,60.3,2197919,2102243,95676,4.4,OA
0,2005,Jan,64.3,61.3,1700922,1623958,76964,4.5,OK
1,2005,Feb,64.3,61.4,1702422,1625949,76473,4.5,OK
2,2005,Mar,64.3,61.5,1703928,1628305,75623,4.4,OK
3,2005,Apr,64.3,61.5,1705764,1630999,74765,4.4,OK
4,2005,May,64.4,61.6,1707881,1633746,74135,4.3,OK
5,2005,Jun,64.4,61.6,1710037,1636192,73845,4.3,OK
6,2005,Jul,64.5,61.7,1712048,1638056,73992,4.3,OK
7,2005,Aug,64.4,61.6,1713560,1639307,74253,4.3,OK
8,2005,Sep,64.3,61.5,1714235,1640181,74054,4.3,OK
9,2005,Oct,64.3,61.5,1714020,1640951,73069,4.3,OK
10,2005,Nov,64.2,61.5,1713063,1641639,71424,4.2,OK
11,2005,Dec,64.0,61.4,1711566,1642007,69559,4.1,OK
12,2006,Jan,63.9,61.4,1710025,1642205,67820,4.0,OK
13,2006,Feb,63.8,61.3,1708921,1642490,66431,3.9,OK
14,2006,Mar,63.7,61.3,1708593,1642958,65635,3.8,OK
15,2006,Apr,63.7,61.2,1709125,1643647,65478,3.8,OK
16,2006,May,63.7,61.2,1710449,1644742,65707,3.8,OK
17,2006,Jun,63.7,61.2,1711998,1645917,66081,3.9,OK
18,2006,Jul,63.7,61.2,1713704,1647247,66457,3.9,OK
19,2006,Aug,63.7,61.2,1715726,1648772,66954,3.9,OK
20,2006,Sep,63.7,61.2,1718058,1650292,67766,3.9,OK
21,2006,Oct,63.7,61.2,1720521,1651829,68692,4.0,OK
22,2006,Nov,63.8,61.2,1722979,1653494,69485,4.0,OK
23,2006,Dec,63.8,61.2,1725014,1654984,70030,4.1,OK
24,2007,Jan,63.8,61.2,1726172,1655845,70327,4.1,OK
25,2007,Feb,63.8,61.2,1726322,1655815,70507,4.1,OK
26,2007,Mar,63.7,61.1,1725376,1654906,70470,4.1,OK
27,2007,Apr,63.6,61.0,1723712,1653537,70175,4.1,OK
28,2007,May,63.5,60.9,1721952,1652156,69796,4.1,OK
29,2007,Jun,63.4,60.8,1720786,1651389,69397,4.0,OK
30,2007,Jul,63.3,60.8,1720470,1651470,69000,4.0,OK
31,2007,Aug,63.3,60.8,1721008,1652431,68577,4.0,OK
32,2007,Sep,63.3,60.8,1722237,1654437,67800,3.9,OK
33,2007,Oct,63.3,60.8,1723543,1657137,66406,3.9,OK
34,2007,Nov,63.2,60.9,1724548,1660213,64335,3.7,OK
35,2007,Dec,63.2,61.0,1725382,1663681,61701,3.6,OK
36,2008,Jan,63.2,61.0,1726265,1667262,59003,3.4,OK
37,2008,Feb,63.2,61.1,1727384,1670591,56793,3.3,OK
38,2008,Mar,63.2,61.2,1729075,1673464,55611,3.2,OK
39,2008,Apr,63.3,61.2,1731478,1675777,55701,3.2,OK
40,2008,May,63.3,61.3,1734689,1677856,56833,3.3,OK
41,2008,Jun,63.4,61.3,1738601,1679997,58604,3.4,OK
42,2008,Jul,63.5,61.3,1742674,1682136,60538,3.5,OK
43,2008,Aug,63.6,61.3,1746499,1683945,62554,3.6,OK
44,2008,Sep,63.6,61.3,1749749,1684673,65076,3.7,OK
45,2008,Oct,63.7,61.2,1752645,1683793,68852,3.9,OK
46,2008,Nov,63.7,61.0,1755374,1680966,74408,4.2,OK
47,2008,Dec,63.8,60.8,1758229,1676316,81913,4.7,OK
48,2009,Jan,63.8,60.5,1761587,1670671,90916,5.2,OK
49,2009,Feb,63.9,60.3,1765678,1665415,100263,5.7,OK
50,2009,Mar,64.0,60.1,1770364,1661702,108662,6.1,OK
51,2009,Apr,64.1,60.0,1774985,1659766,115219,6.5,OK
52,2009,May,64.2,59.9,1778265,1658576,119689,6.7,OK
53,2009,Jun,64.2,59.8,1779326,1657117,122209,6.9,OK
54,2009,Jul,64.0,59.6,1777772,1654657,123115,6.9,OK
55,2009,Aug,63.9,59.4,1773942,1650963,122979,6.9,OK
56,2009,Sep,63.6,59.2,1769326,1646669,122657,6.9,OK
57,2009,Oct,63.4,59.0,1765197,1642579,122618,6.9,OK
58,2009,Nov,63.3,58.9,1762634,1639789,122845,7.0,OK
59,2009,Dec,63.2,58.8,1762250,1639144,123106,7.0,OK
60,2010,Jan,63.2,58.8,1763483,1640540,122943,7.0,OK
61,2010,Feb,63.2,58.9,1765258,1643105,122153,6.9,OK
62,2010,Mar,63.3,58.9,1766675,1645979,120696,6.8,OK
63,2010,Apr,62.3,58.1,1767216,1648598,118618,6.7,OK
64,2010,May,62.2,58.1,1766844,1650772,116072,6.6,OK
65,2010,Jun,62.1,58.1,1765862,1652192,113670,6.4,OK
66,2010,Jul,62.0,58.1,1764974,1652848,112126,6.4,OK
67,2010,Aug,62.0,58.1,1764631,1653189,111442,6.3,OK
68,2010,Sep,61.9,58.0,1764391,1653363,111028,6.3,OK
69,2010,Oct,61.9,58.0,1764070,1653719,110351,6.3,OK
70,2010,Nov,61.8,58.0,1763618,1654525,109093,6.2,OK
71,2010,Dec,61.7,58.0,1762867,1655823,107044,6.1,OK
72,2011,Jan,61.7,58.0,1761984,1657557,104427,5.9,OK
73,2011,Feb,61.6,58.0,1760853,1659149,101704,5.8,OK
74,2011,Mar,61.5,58.0,1759425,1660147,99278,5.6,OK
75,2011,Apr,61.4,58.0,1758254,1660641,97613,5.6,OK
76,2011,May,61.4,58.0,1758164,1661115,97049,5.5,OK
77,2011,Jun,61.4,58.0,1759602,1662261,97341,5.5,OK
78,2011,Jul,61.5,58.0,1762735,1664718,98017,5.6,OK
79,2011,Aug,61.6,58.1,1767198,1668501,98697,5.6,OK
80,2011,Sep,61.7,58.2,1772359,1673387,98972,5.6,OK
81,2011,Oct,61.8,58.4,1777478,1678931,98547,5.5,OK
82,2011,Nov,61.9,58.5,1781679,1684282,97397,5.5,OK
83,2011,Dec,62.0,58.6,1784491,1688775,95716,5.4,OK
84,2012,Jan,62.0,58.7,1786242,1692448,93794,5.3,OK
85,2012,Feb,62.0,58.8,1787662,1695613,92049,5.1,OK
86,2012,Mar,62.0,58.8,1789039,1698086,90953,5.1,OK
87,2012,Apr,62.0,58.9,1790363,1699795,90568,5.1,OK
88,2012,May,62.0,58.9,1791951,1701275,90676,5.1,OK
89,2012,Jun,62.0,58.9,1793879,1702959,90920,5.1,OK
90,2012,Jul,62.0,58.9,1795981,1705012,90969,5.1,OK
91,2012,Aug,62.1,58.9,1798319,1707423,90896,5.1,OK
92,2012,Sep,62.1,59.0,1800762,1709795,90967,5.1,OK
93,2012,Oct,62.1,59.0,1802490,1711251,91239,5.1,OK
94,2012,Nov,62.1,58.9,1802927,1711235,91692,5.1,OK
95,2012,Dec,62.0,58.8,1802218,1709988,92230,5.1,OK
96,2013,Jan,61.9,58.7,1800908,1708092,92816,5.2,OK
97,2013,Feb,61.8,58.6,1799714,1706445,93269,5.2,OK
98,2013,Mar,61.8,58.6,1799353,1706007,93346,5.2,OK
99,2013,Apr,61.8,58.6,1800235,1707161,93074,5.2,OK
100,2013,May,61.8,58.6,1801681,1708925,92756,5.1,OK
101,2013,Jun,61.7,58.6,1802864,1710192,92672,5.1,OK
102,2013,Jul,61.7,58.5,1803164,1710369,92795,5.1,OK
103,2013,Aug,61.6,58.5,1802134,1709443,92691,5.1,OK
104,2013,Sep,61.5,58.4,1800109,1707972,92137,5.1,OK
105,2013,Oct,61.4,58.3,1798068,1706719,91349,5.1,OK
106,2013,Nov,61.3,58.2,1796614,1706259,90355,5.0,OK
107,2013,Dec,61.2,58.2,1795533,1706508,89025,5.0,OK
108,2014,Jan,61.1,58.2,1794313,1707122,87191,4.9,OK
109,2014,Feb,61.1,58.2,1792880,1707926,84954,4.7,OK
110,2014,Mar,61.0,58.2,1791504,1708779,82725,4.6,OK
111,2014,Apr,60.9,58.2,1790356,1709600,80756,4.5,OK
112,2014,May,60.9,58.2,1790090,1711113,78977,4.4,OK
113,2014,Jun,60.9,58.2,1791491,1714066,77425,4.3,OK
114,2014,Jul,60.9,58.3,1794276,1718123,76153,4.2,OK
115,2014,Aug,61.0,58.4,1798094,1722930,75164,4.2,OK
116,2014,Sep,61.1,58.6,1802468,1728111,74357,4.1,OK
117,2014,Oct,61.2,58.7,1806752,1733263,73489,4.1,OK
118,2014,Nov,61.2,58.8,1810599,1737920,72679,4.0,OK
119,2014,Dec,61.3,58.9,1814538,1742065,72473,4.0,OK
120,2015,Jan,61.4,59.0,1819030,1745819,73211,4.0,OK
121,2015,Feb,61.6,59.0,1823885,1749030,74855,4.1,OK
122,2015,Mar,61.7,59.1,1828473,1751584,76889,4.2,OK
123,2015,Apr,61.8,59.1,1831977,1753289,78688,4.3,OK
124,2015,May,61.8,59.1,1833635,1753826,79809,4.4,OK
125,2015,Jun,61.7,59.0,1833226,1753090,80136,4.4,OK
126,2015,Jul,61.6,58.9,1831607,1751708,79899,4.4,OK
127,2015,Aug,61.5,58.8,1829635,1750196,79439,4.3,OK
128,2015,Sep,61.4,58.8,1828048,1749022,79026,4.3,OK
129,2015,Oct,61.4,58.7,1827831,1748766,79065,4.3,OK
130,2015,Nov,61.4,58.7,1829254,1749506,79748,4.4,OK
131,2015,Dec,61.4,58.7,1831352,1750553,80799,4.4,OK
132,2016,Jan,61.4,58.7,1832930,1751007,81923,4.5,OK
133,2016,Feb,61.4,58.7,1833389,1750363,83026,4.5,OK
134,2016,Mar,61.4,58.6,1832699,1748627,84072,4.6,OK
135,2016,Apr,61.3,58.5,1831282,1746117,85165,4.7,OK
136,2016,May,61.2,58.3,1829596,1743321,86275,4.7,OK
137,2016,Jun,61.1,58.2,1828018,1740924,87094,4.8,OK
138,2016,Jul,61.1,58.1,1826864,1739455,87409,4.8,OK
139,2016,Aug,61.0,58.1,1826152,1738948,87204,4.8,OK
140,2016,Sep,61.0,58.1,1825492,1738937,86555,4.7,OK
141,2016,Oct,60.9,58.1,1824350,1738956,85394,4.7,OK
142,2016,Nov,60.9,58.1,1822914,1739205,83709,4.6,OK
143,2016,Dec,60.8,58.1,1821747,1740013,81734,4.5,OK
144,2017,Jan,60.9,58.2,1816237,1736893,79344,4.4,OK
145,2017,Feb,60.9,58.3,1816717,1739314,77403,4.3,OK
146,2017,Mar,60.9,58.4,1818055,1742293,75762,4.2,OK
147,2017,Apr,61.0,58.5,1820464,1745904,74560,4.1,OK
148,2017,May,61.1,58.6,1823836,1750065,73771,4.0,OK
149,2017,Jun,61.2,58.7,1827363,1754030,73333,4.0,OK
150,2017,Jul,61.3,58.8,1830241,1757151,73090,4.0,OK
151,2017,Aug,61.3,58.9,1832044,1759249,72795,4.0,OK
152,2017,Sep,61.3,58.9,1832860,1760592,72268,3.9,OK
153,2017,Oct,61.3,58.9,1833120,1761711,71409,3.9,OK
154,2017,Nov,61.3,58.9,1833177,1762825,70352,3.8,OK
155,2017,Dec,61.3,59.0,1833562,1764458,69104,3.8,OK
156,2018,Jan,61.3,59.1,1834763,1767077,67686,3.7,OK
157,2018,Feb,61.4,59.2,1836758,1770627,66131,3.6,OK
158,2018,Mar,61.4,59.3,1838694,1774324,64370,3.5,OK
159,2018,Apr,61.4,59.4,1839219,1776875,62344,3.4,OK
160,2018,May,61.4,59.4,1837832,1777529,60303,3.3,OK
161,2018,Jun,61.3,59.3,1835106,1776613,58493,3.2,OK
162,2018,Jul,61.1,59.2,1831756,1774746,57010,3.1,OK
163,2018,Aug,61.0,59.1,1828748,1772597,56151,3.1,OK
164,2018,Sep,60.9,59.0,1826820,1770699,56121,3.1,OK
165,2018,Oct,60.8,58.9,1826395,1769603,56792,3.1,OK
166,2018,Nov,60.8,58.9,1827494,1769796,57698,3.2,OK
167,2018,Dec,60.9,58.9,1829710,1771389,58321,3.2,OK
168,2019,Jan,60.9,59.0,1832147,1773817,58330,3.2,OK
169,2019,Feb,61.0,59.1,1834216,1776553,57663,3.1,OK
170,2019,Mar,61.0,59.1,1835861,1779166,56695,3.1,OK
171,2019,Apr,61.1,59.2,1837365,1781511,55854,3.0,OK
172,2019,May,61.1,59.2,1838847,1783281,55566,3.0,OK
173,2019,Jun,61.1,59.2,1840293,1784180,56113,3.0,OK
174,2019,Jul,61.1,59.2,1841696,1784378,57318,3.1,OK
175,2019,Aug,61.1,59.2,1842990,1784504,58486,3.2,OK
176,2019,Sep,61.1,59.1,1844198,1785389,58809,3.2,OK
177,2019,Oct,61.1,59.1,1844979,1786551,58428,3.2,OK
178,2019,Nov,61.0,59.1,1844748,1787011,57737,3.1,OK
179,2019,Dec,60.9,59.0,1842888,1785567,57321,3.1,OK
180,2020,Jan,60.8,58.9,1839449,1781982,57467,3.1,OK
181,2020,Feb,60.6,58.7,1834987,1776825,58162,3.2,OK
182,2020,Mar,60.4,58.5,1830782,1771785,58997,3.2,OK
183,2020,Apr,59.6,52.1,1807286,1579616,227670,12.6,OK
184,2020,May,60.2,54.4,1825960,1648969,176991,9.7,OK
185,2020,Jun,60.1,55.3,1821785,1675891,145894,8.0,OK
186,2020,Jul,60.4,56.1,1833060,1701400,131660,7.2,OK
187,2020,Aug,60.4,56.7,1835237,1721632,113605,6.2,OK
188,2020,Sep,60.7,57.2,1845175,1737275,107900,5.8,OK
189,2020,Oct,60.7,57.4,1847196,1747099,100097,5.4,OK
190,2020,Nov,60.8,57.6,1851037,1753412,97625,5.3,OK
191,2020,Dec,60.9,57.7,1853477,1757823,95654,5.2,OK
192,2021,Jan,60.8,57.8,1853961,1761974,91987,5.0,OK
193,2021,Feb,60.9,57.9,1855894,1766563,89331,4.8,OK
194,2021,Mar,60.9,58.1,1858470,1771536,86934,4.7,OK
195,2021,Apr,60.9,58.2,1860441,1775836,84605,4.5,OK
196,2021,May,60.9,58.2,1860707,1779084,81623,4.4,OK
197,2021,Jun,60.8,58.3,1859561,1781212,78349,4.2,OK
198,2021,Jul,60.6,58.3,1856058,1783560,72498,3.9,OK
199,2021,Aug,60.5,58.3,1852156,1786534,65622,3.5,OK
200,2021,Sep,60.3,58.4,1849254,1790621,58633,3.2,OK
201,2021,Oct,60.2,58.5,1848267,1794701,53566,2.9,OK
202,2021,Nov,60.2,58.5,1848840,1796389,52451,2.8,OK
203,2021,Dec,60.1,58.4,1849500,1796843,52657,2.8,OK
204,2022,Jan,60.1,58.5,1850707,1801100,49607,2.7,OK
205,2022,Feb,60.2,58.6,1853819,1804814,49005,2.6,OK
206,2022,Mar,60.4,58.8,1862191,1812744,49447,2.7,OK
207,2022,Apr,60.5,58.9,1868236,1817164,51072,2.7,OK
208,2022,May,60.7,59.0,1875105,1823024,52081,2.8,OK
209,2022,Jun,60.7,59.0,1876664,1823001,53663,2.9,OK
210,2022,Jul,60.7,59.0,1879867,1824951,54916,2.9,OK
211,2022,Aug,60.7,58.9,1882148,1824664,57484,3.1,OK
212,2022,Sep,60.6,58.7,1881084,1820608,60476,3.2,OK
213,2022,Oct,60.6,58.5,1880755,1817182,63573,3.4,OK
214,2022,Nov,60.5,58.5,1881608,1817135,64473,3.4,OK
0,2005,Jan,67.9,64.0,4529287,4269353,259934,5.7,GA
1,2005,Feb,68.0,64.0,4543128,4279783,263345,5.8,GA
2,2005,Mar,68.1,64.1,4557632,4292843,264789,5.8,GA
3,2005,Apr,68.1,64.2,4572349,4307651,264698,5.8,GA
4,2005,May,68.2,64.3,4586838,4322968,263870,5.8,GA
5,2005,Jun,68.3,64.4,4600177,4337087,263090,5.7,GA
6,2005,Jul,68.3,64.4,4611806,4348844,262962,5.7,GA
7,2005,Aug,68.3,64.4,4621335,4358286,263049,5.7,GA
8,2005,Sep,68.3,64.4,4628993,4366401,262592,5.7,GA
9,2005,Oct,68.2,64.3,4635374,4374745,260629,5.6,GA
10,2005,Nov,68.1,64.3,4641476,4384358,257118,5.5,GA
11,2005,Dec,68.1,64.4,4647812,4395233,252579,5.4,GA
12,2006,Jan,68.0,64.4,4654813,4406965,247848,5.3,GA
13,2006,Feb,68.0,64.5,4662900,4418947,243953,5.2,GA
14,2006,Mar,68.0,64.5,4672236,4430502,241734,5.2,GA
15,2006,Apr,68.1,64.5,4682594,4441462,241132,5.1,GA
16,2006,May,68.1,64.6,4693623,4452478,241145,5.1,GA
17,2006,Jun,68.1,64.6,4705063,4464013,241050,5.1,GA
18,2006,Jul,68.2,64.7,4717188,4476911,240277,5.1,GA
19,2006,Aug,68.2,64.8,4730491,4491354,239137,5.1,GA
20,2006,Sep,68.3,64.9,4744336,4506631,237705,5.0,GA
21,2006,Oct,68.3,64.9,4757415,4521848,235567,5.0,GA
22,2006,Nov,68.4,65.0,4768552,4535543,233009,4.9,GA
23,2006,Dec,68.3,65.0,4776763,4546384,230379,4.8,GA
24,2007,Jan,68.3,65.0,4781979,4553801,228178,4.8,GA
25,2007,Feb,68.2,65.0,4785242,4558332,226910,4.7,GA
26,2007,Mar,68.1,64.9,4787416,4560839,226577,4.7,GA
27,2007,Apr,68.0,64.8,4789823,4562579,227244,4.7,GA
28,2007,May,67.9,64.7,4793806,4564652,229154,4.8,GA
29,2007,Jun,67.9,64.6,4799738,4567895,231843,4.8,GA
30,2007,Jul,67.9,64.6,4807351,4572460,234891,4.9,GA
31,2007,Aug,67.9,64.5,4816462,4578064,238398,4.9,GA
32,2007,Sep,67.9,64.5,4826570,4584166,242404,5.0,GA
33,2007,Oct,68.0,64.5,4836836,4589565,247271,5.1,GA
34,2007,Nov,68.0,64.5,4846765,4594075,252690,5.2,GA
35,2007,Dec,68.1,64.4,4856726,4598040,258686,5.3,GA
36,2008,Jan,68.1,64.4,4866898,4601237,265661,5.5,GA
37,2008,Feb,68.2,64.4,4877596,4604149,273447,5.6,GA
38,2008,Mar,68.3,64.3,4889427,4607194,282233,5.8,GA
39,2008,Apr,68.3,64.3,4902145,4609997,292148,6.0,GA
40,2008,May,68.4,64.2,4915122,4611993,303129,6.2,GA
41,2008,Jun,68.5,64.1,4928114,4612997,315117,6.4,GA
42,2008,Jul,68.6,64.0,4940633,4612633,328000,6.6,GA
43,2008,Aug,68.7,63.9,4952285,4610521,341764,6.9,GA
44,2008,Sep,66.5,61.5,4800201,4442850,357351,7.4,GA
45,2008,Oct,65.9,60.7,4763216,4387423,375793,7.9,GA
46,2008,Nov,65.8,60.3,4761050,4364135,396915,8.3,GA
47,2008,Dec,65.8,60.0,4768790,4349635,419155,8.8,GA
48,2009,Jan,65.9,59.8,4778508,4337640,440868,9.2,GA
49,2009,Feb,65.9,59.6,4787926,4326851,461075,9.6,GA
50,2009,Mar,66.0,59.4,4796410,4318122,478288,10.0,GA
51,2009,Apr,66.0,59.2,4803528,4311940,491588,10.2,GA
52,2009,May,66.0,59.1,4807998,4306652,501346,10.4,GA
53,2009,Jun,65.9,59.0,4809047,4300595,508452,10.6,GA
54,2009,Jul,65.8,58.8,4806283,4292715,513568,10.7,GA
55,2009,Aug,65.6,58.6,4799902,4282945,516957,10.8,GA
56,2009,Sep,65.4,58.4,4791624,4272839,518785,10.8,GA
57,2009,Oct,65.2,58.2,4783230,4264115,519115,10.9,GA
58,2009,Nov,65.1,58.0,4777540,4258854,518686,10.9,GA
59,2009,Dec,65.0,57.9,4776286,4258241,518045,10.8,GA
60,2010,Jan,64.9,57.9,4778162,4261834,516328,10.8,GA
61,2010,Feb,64.2,57.2,4725950,4213413,512537,10.8,GA
62,2010,Mar,63.9,57.0,4708859,4201580,507279,10.8,GA
63,2010,Apr,64.6,57.7,4701086,4199284,501802,10.7,GA
64,2010,May,64.5,57.6,4695916,4199284,496632,10.6,GA
65,2010,Jun,64.3,57.6,4692273,4199144,493129,10.5,GA
66,2010,Jul,64.2,57.5,4691252,4198521,492731,10.5,GA
67,2010,Aug,64.2,57.4,4693766,4198504,495262,10.6,GA
68,2010,Sep,64.2,57.4,4698525,4199495,499030,10.6,GA
69,2010,Oct,64.2,57.4,4703944,4202054,501890,10.7,GA
70,2010,Nov,64.2,57.4,4708019,4205813,502206,10.7,GA
71,2010,Dec,64.2,57.4,4709976,4210339,499637,10.6,GA
72,2011,Jan,64.2,57.4,4711595,4216168,495427,10.5,GA
73,2011,Feb,64.1,57.5,4713939,4222918,491021,10.4,GA
74,2011,Mar,64.1,57.5,4716845,4229650,487195,10.3,GA
75,2011,Apr,64.1,57.5,4720314,4235488,484826,10.3,GA
76,2011,May,64.1,57.6,4725451,4240831,484620,10.3,GA
77,2011,Jun,64.2,57.6,4732626,4247308,485318,10.3,GA
78,2011,Jul,64.2,57.7,4741366,4256369,484997,10.2,GA
79,2011,Aug,64.3,57.7,4750409,4267651,482758,10.2,GA
80,2011,Sep,64.3,57.8,4758203,4279885,478318,10.1,GA
81,2011,Oct,64.3,57.9,4764049,4291750,472299,9.9,GA
82,2011,Nov,64.3,58.0,4767256,4301696,465560,9.8,GA
83,2011,Dec,64.2,58.0,4767599,4308707,458892,9.6,GA
84,2012,Jan,64.1,58.0,4765809,4312847,452962,9.5,GA
85,2012,Feb,64.0,58.0,4764273,4315884,448389,9.4,GA
86,2012,Mar,64.0,58.0,4764404,4318945,445459,9.3,GA
87,2012,Apr,63.9,58.0,4765619,4322617,443002,9.3,GA
88,2012,May,63.9,58.0,4767757,4327976,439781,9.2,GA
89,2012,Jun,63.8,58.0,4770468,4335207,435261,9.1,GA
90,2012,Jul,63.8,58.0,4773009,4343500,429509,9.0,GA
91,2012,Aug,63.8,58.1,4775669,4351928,423741,8.9,GA
92,2012,Sep,63.7,58.2,4778749,4359383,419366,8.8,GA
93,2012,Oct,63.7,58.2,4780398,4364003,416395,8.7,GA
94,2012,Nov,63.6,58.1,4779443,4365109,414334,8.7,GA
95,2012,Dec,63.5,58.1,4776076,4363590,412486,8.6,GA
96,2013,Jan,63.4,58.0,4771071,4360605,410466,8.6,GA
97,2013,Feb,63.3,57.9,4765817,4357909,407908,8.6,GA
98,2013,Mar,63.2,57.8,4761620,4357295,404325,8.5,GA
99,2013,Apr,63.1,57.8,4759649,4359853,399796,8.4,GA
100,2013,May,63.1,57.8,4758784,4363716,395068,8.3,GA
101,2013,Jun,63.0,57.8,4757233,4366608,390625,8.2,GA
102,2013,Jul,62.9,57.8,4753872,4367542,386330,8.1,GA
103,2013,Aug,62.7,57.7,4747684,4366691,380993,8.0,GA
104,2013,Sep,62.6,57.6,4739785,4365522,374263,7.9,GA
105,2013,Oct,62.4,57.6,4733883,4366214,367669,7.8,GA
106,2013,Nov,62.3,57.6,4732267,4370024,362243,7.7,GA
107,2013,Dec,62.3,57.6,4734481,4376243,358238,7.6,GA
108,2014,Jan,62.3,57.6,4738716,4383593,355123,7.5,GA
109,2014,Feb,62.3,57.7,4743210,4390706,352504,7.4,GA
110,2014,Mar,62.3,57.7,4746928,4396047,350881,7.4,GA
111,2014,Apr,62.2,57.6,4748750,4398631,350119,7.4,GA
112,2014,May,62.2,57.6,4748727,4399795,348932,7.3,GA
113,2014,Jun,62.1,57.6,4748412,4401903,346509,7.3,GA
114,2014,Jul,62.0,57.6,4748222,4405529,342693,7.2,GA
115,2014,Aug,62.0,57.5,4748449,4410760,337689,7.1,GA
116,2014,Sep,61.9,57.6,4748685,4416904,331781,7.0,GA
117,2014,Oct,61.8,57.6,4747387,4422548,324839,6.8,GA
118,2014,Nov,61.7,57.5,4744010,4426681,317329,6.7,GA
119,2014,Dec,61.5,57.5,4740275,4429609,310666,6.6,GA
120,2015,Jan,61.4,57.5,4737642,4431983,305659,6.5,GA
121,2015,Feb,61.4,57.4,4736239,4433957,302282,6.4,GA
122,2015,Mar,61.3,57.4,4735865,4436481,299384,6.3,GA
123,2015,Apr,61.2,57.4,4735991,4439804,296187,6.3,GA
124,2015,May,61.1,57.4,4735398,4442925,292473,6.2,GA
125,2015,Jun,61.0,57.3,4733228,4444943,288285,6.1,GA
126,2015,Jul,60.9,57.3,4730359,4446220,284139,6.0,GA
127,2015,Aug,60.8,57.2,4728148,4447634,280514,5.9,GA
128,2015,Sep,60.7,57.2,4727779,4450420,277359,5.9,GA
129,2015,Oct,60.7,57.2,4730976,4456067,274909,5.8,GA
130,2015,Nov,60.7,57.2,4737800,4464354,273446,5.8,GA
131,2015,Dec,60.7,57.2,4745734,4473442,272292,5.7,GA
132,2016,Jan,60.7,57.2,4752310,4481522,270788,5.7,GA
133,2016,Feb,60.7,57.2,4756401,4487435,268966,5.7,GA
134,2016,Mar,61.1,57.7,4796311,4529480,266831,5.6,GA
135,2016,Apr,61.5,58.1,4833906,4568888,265018,5.5,GA
136,2016,May,61.9,58.5,4870975,4606634,264341,5.4,GA
137,2016,Jun,62.3,58.9,4908561,4643573,264988,5.4,GA
138,2016,Jul,62.7,59.3,4947062,4680456,266606,5.4,GA
139,2016,Aug,63.1,59.7,4986532,4717653,268879,5.4,GA
140,2016,Sep,63.3,59.9,5007844,4736489,271355,5.4,GA
141,2016,Oct,64.0,60.5,5065858,4793054,272804,5.4,GA
142,2016,Nov,63.9,60.5,5066497,4794312,272185,5.4,GA
143,2016,Dec,63.8,60.4,5068628,4799051,269577,5.3,GA
144,2017,Jan,63.8,60.5,5073481,4808548,264933,5.2,GA
145,2017,Feb,63.8,60.6,5079507,4819383,260124,5.1,GA
146,2017,Mar,63.9,60.7,5086362,4830976,255386,5.0,GA
147,2017,Apr,63.9,60.7,5094342,4843239,251103,4.9,GA
148,2017,May,63.9,60.8,5103277,4856196,247081,4.8,GA
149,2017,Jun,64.0,60.9,5112111,4868580,243531,4.8,GA
150,2017,Jul,64.0,61.0,5119769,4879233,240536,4.7,GA
151,2017,Aug,64.0,61.0,5124787,4887201,237586,4.6,GA
152,2017,Sep,63.9,61.0,5126751,4892228,234523,4.6,GA
153,2017,Oct,63.9,61.0,5126320,4894923,231397,4.5,GA
154,2017,Nov,63.8,60.9,5124282,4895940,228342,4.5,GA
155,2017,Dec,63.7,60.9,5121949,4896980,224969,4.4,GA
156,2018,Jan,63.6,60.9,5121349,4899971,221378,4.3,GA
157,2018,Feb,63.6,60.9,5124091,4906243,217848,4.3,GA
158,2018,Mar,63.6,60.9,5129015,4914677,214338,4.2,GA
159,2018,Apr,63.6,61.0,5132228,4921697,210531,4.1,GA
160,2018,May,63.5,60.9,5131100,4924450,206650,4.0,GA
161,2018,Jun,63.4,60.8,5126075,4923125,202950,4.0,GA
162,2018,Jul,63.2,60.7,5118911,4919133,199778,3.9,GA
163,2018,Aug,63.0,60.6,5112740,4914711,198029,3.9,GA
164,2018,Sep,62.9,60.5,5109468,4911509,197959,3.9,GA
165,2018,Oct,62.9,60.4,5109644,4910664,198980,3.9,GA
166,2018,Nov,62.8,60.4,5112673,4912622,200051,3.9,GA
167,2018,Dec,62.8,60.4,5117418,4917216,200202,3.9,GA
168,2019,Jan,62.8,60.4,5122344,4923526,198818,3.9,GA
169,2019,Feb,62.8,60.4,5126316,4930723,195593,3.8,GA
170,2019,Mar,62.8,60.4,5129922,4938312,191610,3.7,GA
171,2019,Apr,62.8,60.5,5134802,4946782,188020,3.7,GA
172,2019,May,62.8,60.5,5141381,4955880,185501,3.6,GA
173,2019,Jun,62.8,60.6,5148892,4964778,184114,3.6,GA
174,2019,Jul,62.8,60.6,5156172,4972757,183415,3.6,GA
175,2019,Aug,62.8,60.6,5162527,4980050,182477,3.5,GA
176,2019,Sep,62.8,60.6,5169114,4988580,180534,3.5,GA
177,2019,Oct,62.9,60.7,5176649,4997914,178735,3.5,GA
178,2019,Nov,62.9,60.7,5184299,5006029,178270,3.4,GA
179,2019,Dec,62.9,60.7,5189527,5009729,179798,3.5,GA
180,2020,Jan,62.8,60.6,5190765,5007778,182987,3.5,GA
181,2020,Feb,62.8,60.5,5188322,5000996,187326,3.6,GA
182,2020,Mar,62.7,60.4,5184807,4993425,191382,3.7,GA
183,2020,Apr,59.6,52.3,4939222,4333375,605847,12.3,GA
184,2020,May,60.9,55.0,5043057,4558551,484506,9.6,GA
185,2020,Jun,60.1,55.1,4984267,4567805,416462,8.4,GA
186,2020,Jul,59.9,55.3,4973135,4590121,383014,7.7,GA
187,2020,Aug,59.6,55.5,4947237,4607015,340222,6.9,GA
188,2020,Sep,59.4,55.6,4941413,4624515,316898,6.4,GA
189,2020,Oct,62.3,58.8,5187767,4897372,290395,5.6,GA
190,2020,Nov,62.2,58.9,5179170,4904628,274542,5.3,GA
191,2020,Dec,62.1,58.9,5174962,4911188,263774,5.1,GA
192,2021,Jan,62.0,59.0,5168344,4919056,249288,4.8,GA
193,2021,Feb,61.9,59.0,5167381,4929263,238118,4.6,GA
194,2021,Mar,61.9,59.2,5171797,4942530,229267,4.4,GA
195,2021,Apr,61.9,59.3,5176910,4955553,221357,4.3,GA
196,2021,May,61.9,59.4,5181417,4967508,213909,4.1,GA
197,2021,Jun,61.9,59.4,5184824,4976603,208221,4.0,GA
198,2021,Jul,61.8,59.5,5186449,4986370,200079,3.9,GA
199,2021,Aug,61.8,59.5,5190033,4998443,191590,3.7,GA
200,2021,Sep,61.8,59.6,5194094,5011335,182759,3.5,GA
201,2021,Oct,61.8,59.7,5200059,5023623,176436,3.4,GA
202,2021,Nov,61.7,59.7,5200289,5026198,174091,3.3,GA
203,2021,Dec,61.6,59.6,5198796,5025224,173572,3.3,GA
204,2022,Jan,61.8,59.8,5215626,5047287,168339,3.2,GA
205,2022,Feb,61.9,60.0,5234632,5068418,166214,3.2,GA
206,2022,Mar,62.1,60.1,5251132,5086068,165064,3.1,GA
207,2022,Apr,62.2,60.3,5267587,5106716,160871,3.1,GA
208,2022,May,62.3,60.5,5281662,5124146,157516,3.0,GA
209,2022,Jun,62.3,60.5,5289456,5134551,154905,2.9,GA
210,2022,Jul,62.2,60.5,5285689,5135511,150178,2.8,GA
211,2022,Aug,62.1,60.3,5278849,5129195,149654,2.8,GA
212,2022,Sep,62.0,60.2,5274491,5126321,148170,2.8,GA
213,2022,Oct,61.8,60.0,5268917,5116812,152105,2.9,GA
214,2022,Nov,61.7,59.8,5262128,5106079,156049,3.0,GA
0,2005,Jan,73.8,70.8,973373,934503,38870,4.0,NE
1,2005,Feb,73.7,70.8,973423,934480,38943,4.0,NE
2,2005,Mar,73.7,70.8,973356,934634,38722,4.0,NE
3,2005,Apr,73.6,70.7,973129,934935,38194,3.9,NE
4,2005,May,73.6,70.7,972854,935419,37435,3.8,NE
5,2005,Jun,73.5,70.7,972611,935960,36651,3.8,NE
6,2005,Jul,73.4,70.7,972543,936425,36118,3.7,NE
7,2005,Aug,73.4,70.7,972541,936709,35832,3.7,NE
8,2005,Sep,73.3,70.7,972334,936752,35582,3.7,NE
9,2005,Oct,73.2,70.5,971736,936622,35114,3.6,NE
10,2005,Nov,73.1,70.5,970846,936489,34357,3.5,NE
11,2005,Dec,73.0,70.4,969870,936544,33326,3.4,NE
12,2006,Jan,72.9,70.4,969001,936904,32097,3.3,NE
13,2006,Feb,72.8,70.5,968388,937521,30867,3.2,NE
14,2006,Mar,72.7,70.5,968167,938255,29912,3.1,NE
15,2006,Apr,72.7,70.5,968417,939016,29401,3.0,NE
16,2006,May,72.7,70.5,969109,939813,29296,3.0,NE
17,2006,Jun,72.8,70.6,970087,940667,29420,3.0,NE
18,2006,Jul,72.8,70.6,971231,941724,29507,3.0,NE
19,2006,Aug,72.9,70.7,972530,943039,29491,3.0,NE
20,2006,Sep,72.9,70.7,973920,944455,29465,3.0,NE
21,2006,Oct,73.0,70.8,975160,945823,29337,3.0,NE
22,2006,Nov,73.0,70.8,975966,947007,28959,3.0,NE
23,2006,Dec,73.0,70.9,976178,947798,28380,2.9,NE
24,2007,Jan,72.9,70.8,976001,948140,27861,2.9,NE
25,2007,Feb,72.9,70.8,975808,948238,27570,2.8,NE
26,2007,Mar,72.8,70.8,975800,948254,27546,2.8,NE
27,2007,Apr,72.8,70.8,976138,948372,27766,2.8,NE
28,2007,May,72.8,70.7,976883,948707,28176,2.9,NE
29,2007,Jun,72.9,70.7,978010,949273,28737,2.9,NE
30,2007,Jul,72.9,70.8,979315,949989,29326,3.0,NE
31,2007,Aug,73.0,70.8,980593,950869,29724,3.0,NE
32,2007,Sep,73.0,70.8,981750,951958,29792,3.0,NE
33,2007,Oct,73.0,70.8,982695,953057,29638,3.0,NE
34,2007,Nov,73.1,70.9,983488,954064,29424,3.0,NE
35,2007,Dec,73.1,70.9,984217,955010,29207,3.0,NE
36,2008,Jan,73.1,70.9,984852,955811,29041,2.9,NE
37,2008,Feb,73.1,70.9,985443,956411,29032,2.9,NE
38,2008,Mar,73.1,70.9,986086,956801,29285,3.0,NE
39,2008,Apr,73.1,70.9,986716,956899,29817,3.0,NE
40,2008,May,73.1,70.8,987230,956699,30531,3.1,NE
41,2008,Jun,73.1,70.8,987667,956407,31260,3.2,NE
42,2008,Jul,73.1,70.7,988067,956138,31929,3.2,NE
43,2008,Aug,73.0,70.6,988463,955768,32695,3.3,NE
44,2008,Sep,73.0,70.5,988765,955119,33646,3.4,NE
45,2008,Oct,73.0,70.4,988947,954101,34846,3.5,NE
46,2008,Nov,72.9,70.2,988981,952612,36369,3.7,NE
47,2008,Dec,72.9,70.0,988919,950668,38251,3.9,NE
48,2009,Jan,72.8,69.8,988763,948435,40328,4.1,NE
49,2009,Feb,72.7,69.6,988607,946270,42337,4.3,NE
50,2009,Mar,72.7,69.5,988641,944615,44026,4.5,NE
51,2009,Apr,72.7,69.4,989011,943699,45312,4.6,NE
52,2009,May,72.7,69.3,989500,943261,46239,4.7,NE
53,2009,Jun,72.6,69.2,989738,942897,46841,4.7,NE
54,2009,Jul,72.6,69.1,989444,942248,47196,4.8,NE
55,2009,Aug,72.4,69.0,988595,941206,47389,4.8,NE
56,2009,Sep,72.3,68.8,987507,939966,47541,4.8,NE
57,2009,Oct,72.2,68.7,986531,938727,47804,4.8,NE
58,2009,Nov,72.1,68.6,986060,937863,48197,4.9,NE
59,2009,Dec,72.0,68.5,986333,937752,48581,4.9,NE
60,2010,Jan,72.1,68.5,987372,938545,48827,4.9,NE
61,2010,Feb,72.1,68.6,988776,939919,48857,4.9,NE
62,2010,Mar,72.2,68.6,990060,941517,48543,4.9,NE
63,2010,Apr,71.4,68.0,991039,943174,47865,4.8,NE
64,2010,May,71.4,68.0,991699,944751,46948,4.7,NE
65,2010,Jun,71.4,68.1,992091,945979,46112,4.6,NE
66,2010,Jul,71.4,68.1,992335,946748,45587,4.6,NE
67,2010,Aug,71.3,68.1,992637,947230,45407,4.6,NE
68,2010,Sep,71.3,68.0,993061,947558,45503,4.6,NE
69,2010,Oct,71.3,68.0,993816,948117,45699,4.6,NE
70,2010,Nov,71.4,68.1,994951,949114,45837,4.6,NE
71,2010,Dec,71.4,68.1,996345,950496,45849,4.6,NE
72,2011,Jan,71.5,68.2,997896,952121,45775,4.6,NE
73,2011,Feb,71.6,68.3,999312,953729,45583,4.6,NE
74,2011,Mar,71.6,68.4,1000380,955070,45310,4.5,NE
75,2011,Apr,71.6,68.4,1000982,955970,45012,4.5,NE
76,2011,May,71.6,68.4,1001373,956621,44752,4.5,NE
77,2011,Jun,71.6,68.4,1001954,957429,44525,4.4,NE
78,2011,Jul,71.6,68.5,1003040,958709,44331,4.4,NE
79,2011,Aug,71.7,68.6,1004575,960475,44100,4.4,NE
80,2011,Sep,71.8,68.7,1006289,962554,43735,4.3,NE
81,2011,Oct,71.8,68.7,1007812,964612,43200,4.3,NE
82,2011,Nov,71.8,68.8,1008729,966232,42497,4.2,NE
83,2011,Dec,71.8,68.8,1008982,967276,41706,4.1,NE
84,2012,Jan,71.8,68.9,1008839,967953,40886,4.1,NE
85,2012,Feb,71.7,68.9,1008717,968546,40171,4.0,NE
86,2012,Mar,71.7,68.8,1008820,969077,39743,3.9,NE
87,2012,Apr,71.7,68.8,1009179,969646,39533,3.9,NE
88,2012,May,71.7,68.9,1009977,970546,39431,3.9,NE
89,2012,Jun,71.7,68.9,1011216,971883,39333,3.9,NE
90,2012,Jul,71.8,69.0,1012787,973628,39159,3.9,NE
91,2012,Aug,71.8,69.1,1014558,975571,38987,3.8,NE
92,2012,Sep,71.9,69.2,1016381,977411,38970,3.8,NE
93,2012,Oct,72.0,69.2,1017762,978737,39025,3.8,NE
94,2012,Nov,72.0,69.2,1018499,979433,39066,3.8,NE
95,2012,Dec,71.9,69.2,1018587,979573,39014,3.8,NE
96,2013,Jan,71.9,69.1,1018110,979223,38887,3.8,NE
97,2013,Feb,71.8,69.1,1017500,978771,38729,3.8,NE
98,2013,Mar,71.7,69.0,1017147,978654,38493,3.8,NE
99,2013,Apr,71.7,69.0,1017223,978991,38232,3.8,NE
100,2013,May,71.7,69.0,1017337,979326,38011,3.7,NE
101,2013,Jun,71.6,69.0,1017004,979203,37801,3.7,NE
102,2013,Jul,71.5,68.9,1015997,978454,37543,3.7,NE
103,2013,Aug,71.3,68.7,1014398,977305,37093,3.7,NE
104,2013,Sep,71.2,68.6,1012637,976235,36402,3.6,NE
105,2013,Oct,71.0,68.5,1011485,975674,35811,3.5,NE
106,2013,Nov,71.0,68.5,1011351,975833,35518,3.5,NE
107,2013,Dec,71.0,68.5,1012031,976601,35430,3.5,NE
108,2014,Jan,71.0,68.5,1013076,977740,35336,3.5,NE
109,2014,Feb,71.0,68.6,1013940,978832,35108,3.5,NE
110,2014,Mar,71.0,68.6,1014248,979472,34776,3.4,NE
111,2014,Apr,71.0,68.5,1013835,979454,34381,3.4,NE
112,2014,May,70.8,68.5,1012989,979097,33892,3.3,NE
113,2014,Jun,70.7,68.4,1012254,978935,33319,3.3,NE
114,2014,Jul,70.7,68.4,1011874,979130,32744,3.2,NE
115,2014,Aug,70.6,68.4,1011897,979646,32251,3.2,NE
116,2014,Sep,70.6,68.4,1012111,980321,31790,3.1,NE
117,2014,Oct,70.5,68.4,1012100,980917,31183,3.1,NE
118,2014,Nov,70.5,68.4,1011615,981159,30456,3.0,NE
119,2014,Dec,70.4,68.3,1010872,980970,29902,3.0,NE
120,2015,Jan,70.3,68.2,1010079,980427,29652,2.9,NE
121,2015,Feb,70.2,68.2,1009386,979687,29699,2.9,NE
122,2015,Mar,70.2,68.1,1009054,979132,29922,3.0,NE
123,2015,Apr,70.2,68.1,1009259,979055,30204,3.0,NE
124,2015,May,70.2,68.0,1009818,979369,30449,3.0,NE
125,2015,Jun,70.2,68.0,1010488,979862,30626,3.0,NE
126,2015,Jul,70.2,68.0,1011241,980537,30704,3.0,NE
127,2015,Aug,70.2,68.1,1012103,981413,30690,3.0,NE
128,2015,Sep,70.2,68.1,1013086,982465,30621,3.0,NE
129,2015,Oct,70.2,68.1,1014321,983776,30545,3.0,NE
130,2015,Nov,70.3,68.2,1015747,985231,30516,3.0,NE
131,2015,Dec,70.3,68.2,1017042,986563,30479,3.0,NE
132,2016,Jan,70.3,68.2,1018062,987626,30436,3.0,NE
133,2016,Feb,70.4,68.2,1018720,988278,30442,3.0,NE
134,2016,Mar,70.3,68.2,1018855,988365,30490,3.0,NE
135,2016,Apr,70.2,68.1,1018474,987872,30602,3.0,NE
136,2016,May,70.2,68.0,1017826,987002,30824,3.0,NE
137,2016,Jun,70.0,67.9,1017046,985933,31113,3.1,NE
138,2016,Jul,69.9,67.8,1016161,984777,31384,3.1,NE
139,2016,Aug,69.8,67.7,1015208,983589,31619,3.1,NE
140,2016,Sep,69.7,67.5,1014279,982416,31863,3.1,NE
141,2016,Oct,69.6,67.4,1013352,981360,31992,3.2,NE
142,2016,Nov,69.5,67.3,1012567,980719,31848,3.1,NE
143,2016,Dec,69.4,67.3,1012214,980735,31479,3.1,NE
144,2017,Jan,69.3,67.2,1018333,986953,31380,3.1,NE
145,2017,Feb,69.3,67.2,1018915,988190,30725,3.0,NE
146,2017,Mar,69.4,67.3,1019921,989735,30186,3.0,NE
147,2017,Apr,69.4,67.4,1021255,991350,29905,2.9,NE
148,2017,May,69.5,67.4,1022712,992866,29846,2.9,NE
149,2017,Jun,69.5,67.5,1024040,994089,29951,2.9,NE
150,2017,Jul,69.5,67.5,1025081,994852,30229,2.9,NE
151,2017,Aug,69.5,67.5,1025609,995094,30515,3.0,NE
152,2017,Sep,69.5,67.4,1025624,994949,30675,3.0,NE
153,2017,Oct,69.4,67.3,1025402,994689,30713,3.0,NE
154,2017,Nov,69.4,67.3,1025248,994579,30669,3.0,NE
155,2017,Dec,69.3,67.3,1025474,995014,30460,3.0,NE
156,2018,Jan,69.4,67.3,1026340,996235,30105,2.9,NE
157,2018,Feb,69.4,67.4,1027974,998256,29718,2.9,NE
158,2018,Mar,69.6,67.6,1030081,1000710,29371,2.9,NE
159,2018,Apr,69.7,67.7,1032045,1002949,29096,2.8,NE
160,2018,May,69.7,67.8,1033500,1004452,29048,2.8,NE
161,2018,Jun,69.7,67.8,1034439,1005173,29266,2.8,NE
162,2018,Jul,69.7,67.7,1035036,1005408,29628,2.9,NE
163,2018,Aug,69.7,67.7,1035731,1005592,30139,2.9,NE
164,2018,Sep,69.7,67.7,1036714,1005974,30740,3.0,NE
165,2018,Oct,69.8,67.7,1037993,1006718,31275,3.0,NE
166,2018,Nov,69.8,67.7,1039462,1007841,31621,3.0,NE
167,2018,Dec,69.9,67.8,1040956,1009244,31712,3.0,NE
168,2019,Jan,70.0,67.9,1042303,1010726,31577,3.0,NE
169,2019,Feb,70.0,67.9,1043415,1012157,31258,3.0,NE
170,2019,Mar,70.1,68.0,1044386,1013430,30956,3.0,NE
171,2019,Apr,70.1,68.0,1045447,1014650,30797,2.9,NE
172,2019,May,70.1,68.1,1046643,1015771,30872,2.9,NE
173,2019,Jun,70.2,68.1,1048085,1016777,31308,3.0,NE
174,2019,Jul,70.3,68.1,1049723,1017661,32062,3.1,NE
175,2019,Aug,70.3,68.1,1051322,1018479,32843,3.1,NE
176,2019,Sep,70.4,68.1,1052850,1019585,33265,3.2,NE
177,2019,Oct,70.4,68.2,1054105,1020853,33252,3.2,NE
178,2019,Nov,70.4,68.2,1054773,1021910,32863,3.1,NE
179,2019,Dec,70.3,68.2,1054316,1022020,32296,3.1,NE
180,2020,Jan,70.2,68.1,1052555,1020813,31742,3.0,NE
181,2020,Feb,70.0,67.9,1049738,1018468,31270,3.0,NE
182,2020,Mar,70.3,67.3,1054949,1009682,45267,4.3,NE
183,2020,Apr,69.6,63.9,1045584,960216,85368,8.2,NE
184,2020,May,69.6,65.2,1045076,979695,65381,6.3,NE
185,2020,Jun,69.3,65.7,1040368,987548,52820,5.1,NE
186,2020,Jul,69.3,66.3,1041547,995459,46088,4.4,NE
187,2020,Aug,69.2,66.7,1040964,1002111,38853,3.7,NE
188,2020,Sep,69.3,67.0,1041629,1007057,34572,3.3,NE
189,2020,Oct,69.1,67.1,1040462,1009793,30669,2.9,NE
190,2020,Nov,69.1,67.2,1040435,1010992,29443,2.8,NE
191,2020,Dec,69.1,67.2,1040558,1011535,29023,2.8,NE
192,2021,Jan,69.1,67.2,1040600,1012452,28148,2.7,NE
193,2021,Feb,69.2,67.3,1041719,1013973,27746,2.7,NE
194,2021,Mar,69.2,67.4,1043369,1015946,27423,2.6,NE
195,2021,Apr,69.3,67.5,1044978,1017905,27073,2.6,NE
196,2021,May,69.4,67.6,1046228,1019663,26565,2.5,NE
197,2021,Jun,69.5,67.7,1047726,1021138,26588,2.5,NE
198,2021,Jul,69.5,67.8,1049460,1022918,26542,2.5,NE
199,2021,Aug,69.6,67.8,1051274,1024863,26411,2.5,NE
200,2021,Sep,69.7,68.0,1053069,1027171,25898,2.5,NE
201,2021,Oct,69.7,68.1,1054654,1029325,25329,2.4,NE
202,2021,Nov,69.7,68.1,1054809,1030005,24804,2.4,NE
203,2021,Dec,69.7,68.0,1054647,1030078,24569,2.3,NE
204,2022,Jan,69.7,68.2,1056446,1032911,23535,2.2,NE
205,2022,Feb,69.8,68.3,1057000,1034669,22331,2.1,NE
206,2022,Mar,69.8,68.5,1058943,1037811,21132,2.0,NE
207,2022,Apr,69.9,68.6,1060739,1040317,20422,1.9,NE
208,2022,May,70.0,68.7,1062659,1042737,19922,1.9,NE
209,2022,Jun,70.0,68.7,1063518,1043281,20237,1.9,NE
210,2022,Jul,70.0,68.6,1063235,1042132,21103,2.0,NE
211,2022,Aug,69.9,68.5,1063182,1040819,22363,2.1,NE
212,2022,Sep,69.9,68.3,1063514,1039873,23641,2.2,NE
213,2022,Oct,69.8,68.2,1063314,1038136,25178,2.4,NE
214,2022,Nov,69.8,68.1,1063337,1036860,26477,2.5,NE
0,2005,Jan,65.6,62.8,4344544,4152756,191788,4.4,NJ
1,2005,Feb,65.7,62.8,4350414,4159584,190830,4.4,NJ
2,2005,Mar,65.8,63.0,4358345,4168674,189671,4.4,NJ
3,2005,Apr,66.0,63.1,4367812,4179346,188466,4.3,NJ
4,2005,May,66.1,63.3,4378176,4190785,187391,4.3,NJ
5,2005,Jun,66.2,63.4,4388369,4201238,187131,4.3,NJ
6,2005,Jul,66.3,63.5,4397469,4208538,188931,4.3,NJ
7,2005,Aug,66.4,63.5,4404658,4211849,192809,4.4,NJ
8,2005,Sep,66.5,63.5,4409444,4211629,197815,4.5,NJ
9,2005,Oct,66.4,63.4,4412517,4210115,202402,4.6,NJ
10,2005,Nov,66.4,63.3,4415274,4209367,205907,4.7,NJ
11,2005,Dec,66.4,63.3,4418378,4209957,208421,4.7,NJ
12,2006,Jan,66.5,63.3,4421798,4211793,210005,4.7,NJ
13,2006,Feb,66.5,63.3,4425264,4214385,210879,4.8,NJ
14,2006,Mar,66.6,63.4,4428914,4217367,211547,4.8,NJ
15,2006,Apr,66.6,63.4,4432546,4220226,212320,4.8,NJ
16,2006,May,66.7,63.5,4435463,4222693,212770,4.8,NJ
17,2006,Jun,66.7,63.5,4437157,4224916,212241,4.8,NJ
18,2006,Jul,66.7,63.5,4438357,4228376,209981,4.7,NJ
19,2006,Aug,66.7,63.6,4440260,4233913,206347,4.6,NJ
20,2006,Sep,66.7,63.7,4442947,4240957,201990,4.5,NJ
21,2006,Oct,66.7,63.7,4445225,4248153,197072,4.4,NJ
22,2006,Nov,66.7,63.8,4445641,4253587,192054,4.3,NJ
23,2006,Dec,66.6,63.8,4443461,4256088,187373,4.2,NJ
24,2007,Jan,66.5,63.8,4439278,4255550,183728,4.1,NJ
25,2007,Feb,66.4,63.7,4434374,4252745,181629,4.1,NJ
26,2007,Mar,66.3,63.6,4429421,4248592,180829,4.1,NJ
27,2007,Apr,66.3,63.6,4425655,4244696,180959,4.1,NJ
28,2007,May,66.2,63.5,4424305,4242385,181920,4.1,NJ
29,2007,Jun,66.2,63.5,4425548,4242159,183389,4.1,NJ
30,2007,Jul,66.2,63.5,4428637,4243568,185069,4.2,NJ
31,2007,Aug,66.3,63.5,4433145,4245978,187167,4.2,NJ
32,2007,Sep,66.3,63.5,4439191,4249429,189762,4.3,NJ
33,2007,Oct,66.4,63.5,4446740,4253671,193069,4.3,NJ
34,2007,Nov,66.5,63.6,4455133,4258556,196577,4.4,NJ
35,2007,Dec,66.6,63.6,4463384,4263387,199997,4.5,NJ
36,2008,Jan,66.7,63.6,4470219,4266692,203527,4.6,NJ
37,2008,Feb,66.7,63.6,4474935,4267757,207178,4.6,NJ
38,2008,Mar,66.7,63.6,4478301,4266825,211476,4.7,NJ
39,2008,Apr,66.8,63.5,4481480,4264339,217141,4.8,NJ
40,2008,May,66.8,63.5,4485779,4261272,224507,5.0,NJ
41,2008,Jun,66.9,63.4,4491804,4258497,233307,5.2,NJ
42,2008,Jul,66.9,63.3,4498916,4256003,242913,5.4,NJ
43,2008,Aug,67.0,63.2,4505811,4252819,252992,5.6,NJ
44,2008,Sep,67.0,63.1,4511156,4246910,264246,5.9,NJ
45,2008,Oct,67.0,62.9,4514528,4236706,277822,6.2,NJ
46,2008,Nov,67.0,62.7,4516496,4222306,294190,6.5,NJ
47,2008,Dec,67.0,62.4,4518176,4205496,312680,6.9,NJ
48,2009,Jan,67.0,62.1,4520580,4188473,332107,7.3,NJ
49,2009,Feb,67.0,61.8,4524867,4173438,351429,7.8,NJ
50,2009,Mar,67.1,61.6,4531179,4162020,369159,8.1,NJ
51,2009,Apr,67.2,61.5,4538278,4154052,384226,8.5,NJ
52,2009,May,67.2,61.4,4544120,4147183,396937,8.7,NJ
53,2009,Jun,67.3,61.2,4547757,4139515,408242,9.0,NJ
54,2009,Jul,67.2,61.0,4548943,4129968,418975,9.2,NJ
55,2009,Aug,67.2,60.8,4548092,4119022,429070,9.4,NJ
56,2009,Sep,67.1,60.6,4546766,4109034,437732,9.6,NJ
57,2009,Oct,67.0,60.5,4545928,4101692,444236,9.8,NJ
58,2009,Nov,67.0,60.4,4547032,4098119,448913,9.9,NJ
59,2009,Dec,67.0,60.4,4551132,4099004,452128,9.9,NJ
60,2010,Jan,67.1,60.4,4557586,4104101,453485,10.0,NJ
61,2010,Feb,67.2,60.5,4563977,4111253,452724,9.9,NJ
62,2010,Mar,67.2,60.6,4568271,4117952,450319,9.9,NJ
63,2010,Apr,66.5,60.0,4569772,4122909,446863,9.8,NJ
64,2010,May,66.5,60.0,4568263,4125803,442460,9.7,NJ
65,2010,Jun,66.4,60.0,4564190,4126170,438020,9.6,NJ
66,2010,Jul,66.3,60.0,4559205,4124395,434810,9.5,NJ
67,2010,Aug,66.2,59.9,4554955,4121586,433369,9.5,NJ
68,2010,Sep,66.1,59.8,4552048,4118480,433568,9.5,NJ
69,2010,Oct,66.0,59.7,4551095,4116728,434367,9.5,NJ
70,2010,Nov,66.0,59.7,4551441,4117046,434395,9.5,NJ
71,2010,Dec,66.0,59.7,4552026,4118834,433192,9.5,NJ
72,2011,Jan,66.0,59.7,4552679,4121291,431388,9.5,NJ
73,2011,Feb,66.0,59.7,4553050,4123511,429539,9.4,NJ
74,2011,Mar,65.9,59.7,4552802,4124964,427838,9.4,NJ
75,2011,Apr,65.9,59.7,4552390,4125619,426771,9.4,NJ
76,2011,May,65.9,59.7,4553143,4126387,426756,9.4,NJ
77,2011,Jun,65.9,59.7,4555798,4128487,427311,9.4,NJ
78,2011,Jul,65.9,59.7,4560254,4132540,427714,9.4,NJ
79,2011,Aug,66.0,59.8,4565687,4138063,427624,9.4,NJ
80,2011,Sep,66.0,59.8,4570767,4143983,426784,9.3,NJ
81,2011,Oct,66.0,59.9,4574465,4148948,425517,9.3,NJ
82,2011,Nov,66.0,59.9,4575923,4151567,424356,9.3,NJ
83,2011,Dec,66.0,59.9,4575109,4151422,423687,9.3,NJ
84,2012,Jan,65.9,59.8,4573226,4149396,423830,9.3,NJ
85,2012,Feb,65.9,59.8,4572104,4146808,425296,9.3,NJ
86,2012,Mar,65.9,59.7,4572304,4143868,428436,9.4,NJ
87,2012,Apr,65.9,59.7,4572964,4140731,432233,9.5,NJ
88,2012,May,65.9,59.6,4574098,4138729,435369,9.5,NJ
89,2012,Jun,65.9,59.6,4575467,4138908,436559,9.5,NJ
90,2012,Jul,65.9,59.6,4576629,4141405,435224,9.5,NJ
91,2012,Aug,65.9,59.6,4578329,4145792,432537,9.4,NJ
92,2012,Sep,65.9,59.7,4581093,4151159,429934,9.4,NJ
93,2012,Oct,65.9,59.7,4583579,4156020,427559,9.3,NJ
94,2012,Nov,65.9,59.8,4584357,4159323,425034,9.3,NJ
95,2012,Dec,65.8,59.8,4582248,4160353,421895,9.2,NJ
96,2013,Jan,65.7,59.7,4576918,4158784,418134,9.1,NJ
97,2013,Feb,65.6,59.7,4569169,4155701,413468,9.0,NJ
98,2013,Mar,65.5,59.6,4560491,4152943,407548,8.9,NJ
99,2013,Apr,65.3,59.6,4552734,4152015,400719,8.8,NJ
100,2013,May,65.2,59.6,4545446,4151597,393849,8.7,NJ
101,2013,Jun,65.1,59.5,4537662,4150253,387409,8.5,NJ
102,2013,Jul,64.9,59.5,4528808,4147947,380861,8.4,NJ
103,2013,Aug,64.7,59.4,4517350,4144838,372512,8.2,NJ
104,2013,Sep,64.5,59.3,4503664,4141572,362092,8.0,NJ
105,2013,Oct,64.3,59.3,4490616,4139153,351463,7.8,NJ
106,2013,Nov,64.2,59.3,4480939,4139036,341903,7.6,NJ
107,2013,Dec,64.1,59.3,4475815,4142292,333523,7.5,NJ
108,2014,Jan,64.0,59.4,4474601,4148926,325675,7.3,NJ
109,2014,Feb,64.1,59.5,4475891,4157794,318097,7.1,NJ
110,2014,Mar,64.1,59.6,4478887,4167358,311529,7.0,NJ
111,2014,Apr,64.1,59.7,4482331,4175971,306360,6.8,NJ
112,2014,May,64.2,59.8,4486012,4183785,302227,6.7,NJ
113,2014,Jun,64.2,59.9,4490716,4191512,299204,6.7,NJ
114,2014,Jul,64.3,60.0,4496114,4198635,297479,6.6,NJ
115,2014,Aug,64.3,60.1,4502037,4205182,296855,6.6,NJ
116,2014,Sep,64.4,60.2,4507583,4211077,296506,6.6,NJ
117,2014,Oct,64.4,60.2,4510847,4215767,295080,6.5,NJ
118,2014,Nov,64.4,60.2,4510783,4218647,292136,6.5,NJ
119,2014,Dec,64.4,60.2,4508668,4220057,288611,6.4,NJ
120,2015,Jan,64.3,60.2,4506245,4221064,285181,6.3,NJ
121,2015,Feb,64.3,60.3,4504414,4222229,282185,6.3,NJ
122,2015,Mar,64.3,60.3,4503300,4224426,278874,6.2,NJ
123,2015,Apr,64.2,60.3,4502099,4227666,274433,6.1,NJ
124,2015,May,64.2,60.4,4499740,4231181,268559,6.0,NJ
125,2015,Jun,64.1,60.4,4495690,4234299,261391,5.8,NJ
126,2015,Jul,64.0,60.4,4490941,4237324,253617,5.6,NJ
127,2015,Aug,64.0,60.5,4486690,4240738,245952,5.5,NJ
128,2015,Sep,63.9,60.5,4483815,4245263,238552,5.3,NJ
129,2015,Oct,63.9,60.6,4484030,4251866,232164,5.2,NJ
130,2015,Nov,63.9,60.7,4487793,4260009,227784,5.1,NJ
131,2015,Dec,64.0,60.8,4493120,4267692,225428,5.0,NJ
132,2016,Jan,64.1,60.9,4497590,4273085,224505,5.0,NJ
133,2016,Feb,64.1,60.9,4500079,4275593,224486,5.0,NJ
134,2016,Mar,64.1,60.9,4500037,4275290,224747,5.0,NJ
135,2016,Apr,64.0,60.8,4498429,4273344,225085,5.0,NJ
136,2016,May,64.0,60.8,4496747,4271365,225382,5.0,NJ
137,2016,Jun,64.0,60.8,4495078,4269959,225119,5.0,NJ
138,2016,Jul,63.9,60.7,4493345,4269348,223997,5.0,NJ
139,2016,Aug,63.9,60.7,4491870,4269454,222416,5.0,NJ
140,2016,Sep,63.8,60.7,4490549,4269602,220947,4.9,NJ
141,2016,Oct,63.8,60.7,4488150,4269123,219027,4.9,NJ
142,2016,Nov,63.7,60.6,4484804,4268999,215805,4.8,NJ
143,2016,Dec,63.6,60.6,4482046,4270453,211593,4.7,NJ
144,2017,Jan,63.6,60.7,4608916,4396117,212799,4.6,NJ
145,2017,Feb,63.6,60.7,4611297,4402506,208791,4.5,NJ
146,2017,Mar,63.6,60.8,4615010,4408891,206119,4.5,NJ
147,2017,Apr,63.6,60.8,4619442,4414239,205203,4.4,NJ
148,2017,May,63.7,60.8,4623330,4417571,205759,4.5,NJ
149,2017,Jun,63.6,60.8,4625598,4418021,207577,4.5,NJ
150,2017,Jul,63.6,60.7,4625490,4415446,210044,4.5,NJ
151,2017,Aug,63.5,60.6,4622153,4410238,211915,4.6,NJ
152,2017,Sep,63.4,60.5,4616269,4403727,212542,4.6,NJ
153,2017,Oct,63.3,60.4,4609435,4397686,211749,4.6,NJ
154,2017,Nov,63.2,60.3,4602632,4392811,209821,4.6,NJ
155,2017,Dec,63.0,60.2,4596953,4390479,206474,4.5,NJ
156,2018,Jan,63.0,60.2,4594473,4392214,202259,4.4,NJ
157,2018,Feb,63.0,60.3,4596940,4398756,198184,4.3,NJ
158,2018,Mar,63.1,60.4,4603382,4408665,194717,4.2,NJ
159,2018,Apr,63.1,60.5,4610320,4418557,191763,4.2,NJ
160,2018,May,63.2,60.6,4614871,4425701,189170,4.1,NJ
161,2018,Jun,63.2,60.6,4616059,4429793,186266,4.0,NJ
162,2018,Jul,63.1,60.6,4614076,4431488,182588,4.0,NJ
163,2018,Aug,63.0,60.6,4611011,4432373,178638,3.9,NJ
164,2018,Sep,63.0,60.6,4609037,4434073,174964,3.8,NJ
165,2018,Oct,62.9,60.6,4609750,4438169,171581,3.7,NJ
166,2018,Nov,63.0,60.7,4613827,4445552,168275,3.6,NJ
167,2018,Dec,63.0,60.8,4620634,4455786,164848,3.6,NJ
168,2019,Jan,63.1,60.9,4628460,4467515,160945,3.5,NJ
169,2019,Feb,63.2,61.1,4636360,4480115,156245,3.4,NJ
170,2019,Mar,63.3,61.2,4644993,4493191,151802,3.3,NJ
171,2019,Apr,63.4,61.4,4655761,4506955,148806,3.2,NJ
172,2019,May,63.6,61.5,4668729,4520462,148267,3.2,NJ
173,2019,Jun,63.7,61.7,4682868,4532262,150606,3.2,NJ
174,2019,Jul,63.9,61.8,4696685,4541439,155246,3.3,NJ
175,2019,Aug,64.0,61.8,4708870,4548271,160599,3.4,NJ
176,2019,Sep,64.1,61.9,4719285,4554604,164681,3.5,NJ
177,2019,Oct,64.2,61.9,4728291,4560779,167512,3.5,NJ
178,2019,Nov,64.3,62.0,4735677,4566400,169277,3.6,NJ
179,2019,Dec,64.3,62.0,4738741,4569196,169545,3.6,NJ
180,2020,Jan,64.2,61.9,4734973,4567040,167933,3.5,NJ
181,2020,Feb,64.0,61.8,4722120,4558665,163455,3.5,NJ
182,2020,Mar,63.7,61.6,4701376,4547065,154311,3.3,NJ
183,2020,Apr,61.2,51.7,4518520,3817750,700770,15.5,NJ
184,2020,May,62.1,52.2,4579556,3854583,724973,15.8,NJ
185,2020,Jun,62.6,53.5,4621364,3949671,671693,14.5,NJ
186,2020,Jul,63.9,54.8,4716522,4043080,673442,14.3,NJ
187,2020,Aug,64.0,55.8,4723079,4117946,605133,12.8,NJ
188,2020,Sep,61.8,56.7,4563575,4183835,379740,8.3,NJ
189,2020,Oct,62.0,57.3,4574059,4229655,344404,7.5,NJ
190,2020,Nov,62.4,57.7,4609217,4264118,345099,7.5,NJ
191,2020,Dec,62.7,58.1,4629359,4287060,342299,7.4,NJ
192,2021,Jan,62.9,58.3,4643010,4303514,339496,7.3,NJ
193,2021,Feb,63.0,58.5,4652693,4318304,334389,7.2,NJ
194,2021,Mar,63.1,58.7,4657234,4334624,322610,6.9,NJ
195,2021,Apr,63.3,58.9,4675610,4349897,325713,7.0,NJ
196,2021,May,63.3,59.1,4672304,4361984,310320,6.6,NJ
197,2021,Jun,63.7,59.2,4702203,4369843,332360,7.1,NJ
198,2021,Jul,63.4,59.2,4684109,4374761,309348,6.6,NJ
199,2021,Aug,63.4,59.3,4683383,4379616,303767,6.5,NJ
200,2021,Sep,63.0,59.3,4656122,4384960,271162,5.8,NJ
201,2021,Oct,62.8,59.4,4646759,4392068,254691,5.5,NJ
202,2021,Nov,62.6,59.4,4633409,4396380,237029,5.1,NJ
203,2021,Dec,62.6,59.4,4632670,4398562,234108,5.1,NJ
204,2022,Jan,62.7,59.5,4641835,4403536,238299,5.1,NJ
205,2022,Feb,62.5,59.6,4622687,4409774,212913,4.6,NJ
206,2022,Mar,62.4,59.8,4617907,4425423,192484,4.2,NJ
207,2022,Apr,62.6,60.0,4634049,4444630,189419,4.1,NJ
208,2022,May,62.8,60.3,4648350,4466973,181377,3.9,NJ
209,2022,Jun,62.9,60.5,4662709,4482786,179923,3.9,NJ
210,2022,Jul,63.0,60.6,4666387,4494274,172113,3.7,NJ
211,2022,Aug,63.3,60.8,4693253,4505032,188221,4.0,NJ
212,2022,Sep,63.0,61.0,4675993,4521874,154119,3.3,NJ
213,2022,Oct,63.3,61.1,4698826,4536787,162039,3.4,NJ
214,2022,Nov,63.5,61.3,4710398,4548798,161600,3.4,NJ
0,2005,Jan,66.2,63.0,687951,654877,33074,4.8,ME
1,2005,Feb,66.3,63.0,689243,655688,33555,4.9,ME
2,2005,Mar,66.4,63.1,690827,656915,33912,4.9,ME
3,2005,Apr,66.5,63.2,692602,658492,34110,4.9,ME
4,2005,May,66.7,63.4,694480,660287,34193,4.9,ME
5,2005,Jun,66.8,63.5,696234,661982,34252,4.9,ME
6,2005,Jul,66.9,63.6,697669,663284,34385,4.9,ME
7,2005,Aug,66.9,63.6,698645,664096,34549,4.9,ME
8,2005,Sep,66.9,63.6,699076,664456,34620,5.0,ME
9,2005,Oct,66.8,63.5,699035,664565,34470,4.9,ME
10,2005,Nov,66.8,63.5,698711,664644,34067,4.9,ME
11,2005,Dec,66.7,63.5,698259,664823,33436,4.8,ME
12,2006,Jan,66.6,63.5,697917,665201,32716,4.7,ME
13,2006,Feb,66.6,63.5,697805,665670,32135,4.6,ME
14,2006,Mar,66.6,63.5,697986,666098,31888,4.6,ME
15,2006,Apr,66.6,63.5,698519,666474,32045,4.6,ME
16,2006,May,66.6,63.5,699299,666812,32487,4.6,ME
17,2006,Jun,66.7,63.5,700153,667096,33057,4.7,ME
18,2006,Jul,66.7,63.5,701038,667451,33587,4.8,ME
19,2006,Aug,66.8,63.5,702011,668042,33969,4.8,ME
20,2006,Sep,66.8,63.6,703009,668866,34143,4.9,ME
21,2006,Oct,66.9,63.6,703851,669845,34006,4.8,ME
22,2006,Nov,66.9,63.7,704327,670736,33591,4.8,ME
23,2006,Dec,66.8,63.7,704222,671172,33050,4.7,ME
24,2007,Jan,66.7,63.6,703506,670974,32532,4.6,ME
25,2007,Feb,66.6,63.6,702423,670267,32156,4.6,ME
26,2007,Mar,66.5,63.4,701102,669145,31957,4.6,ME
27,2007,Apr,66.3,63.3,699674,667728,31946,4.6,ME
28,2007,May,66.1,63.1,698469,666311,32158,4.6,ME
29,2007,Jun,66.0,63.0,697735,665225,32510,4.7,ME
30,2007,Jul,66.0,62.9,697547,664650,32897,4.7,ME
31,2007,Aug,66.0,62.8,697898,664625,33273,4.8,ME
32,2007,Sep,66.0,62.9,698665,665148,33517,4.8,ME
33,2007,Oct,66.1,62.9,699588,666019,33569,4.8,ME
34,2007,Nov,66.1,63.0,700420,667037,33383,4.8,ME
35,2007,Dec,66.1,63.0,701031,668042,32989,4.7,ME
36,2008,Jan,66.1,63.1,701344,668746,32598,4.6,ME
37,2008,Feb,66.1,63.1,701507,669081,32426,4.6,ME
38,2008,Mar,66.2,63.1,701834,669166,32668,4.7,ME
39,2008,Apr,66.2,63.0,702403,669018,33385,4.8,ME
40,2008,May,66.2,63.0,703056,668592,34464,4.9,ME
41,2008,Jun,66.2,62.9,703584,667838,35746,5.1,ME
42,2008,Jul,66.2,62.7,703689,666608,37081,5.3,ME
43,2008,Aug,66.1,62.5,703231,664756,38475,5.5,ME
44,2008,Sep,66.0,62.3,702387,662212,40175,5.7,ME
45,2008,Oct,65.9,61.9,701476,659005,42471,6.1,ME
46,2008,Nov,65.9,61.6,700719,655292,45427,6.5,ME
47,2008,Dec,65.8,61.2,700292,651465,48827,7.0,ME
48,2009,Jan,65.8,60.9,700203,647898,52305,7.5,ME
49,2009,Feb,65.8,60.6,700270,644828,55442,7.9,ME
50,2009,Mar,65.8,60.4,700301,642493,57808,8.3,ME
51,2009,Apr,65.8,60.2,700192,640979,59213,8.5,ME
52,2009,May,65.7,60.1,699741,639964,59777,8.5,ME
53,2009,Jun,65.6,60.0,698904,639123,59781,8.6,ME
54,2009,Jul,65.5,59.9,697805,638257,59548,8.5,ME
55,2009,Aug,65.4,59.8,696562,637239,59323,8.5,ME
56,2009,Sep,65.3,59.7,695385,636129,59256,8.5,ME
57,2009,Oct,65.2,59.6,694561,635139,59422,8.6,ME
58,2009,Nov,65.1,59.5,694427,634580,59847,8.6,ME
59,2009,Dec,65.2,59.5,695077,634656,60421,8.7,ME
60,2010,Jan,65.3,59.6,696250,635414,60836,8.7,ME
61,2010,Feb,65.4,59.7,697409,636533,60876,8.7,ME
62,2010,Mar,65.5,59.8,698109,637570,60539,8.7,ME
63,2010,Apr,65.0,59.4,698248,638356,59892,8.6,ME
64,2010,May,65.0,59.5,697946,638921,59025,8.5,ME
65,2010,Jun,64.9,59.5,697428,639223,58205,8.3,ME
66,2010,Jul,64.9,59.5,697027,639323,57704,8.3,ME
67,2010,Aug,64.8,59.5,697050,639483,57567,8.3,ME
68,2010,Sep,64.8,59.5,697492,639857,57635,8.3,ME
69,2010,Oct,64.9,59.5,698162,640515,57647,8.3,ME
70,2010,Nov,64.9,59.6,698775,641355,57420,8.2,ME
71,2010,Dec,64.9,59.6,699099,642145,56954,8.1,ME
72,2011,Jan,64.9,59.7,699101,642726,56375,8.1,ME
73,2011,Feb,64.8,59.7,698816,643048,55768,8.0,ME
74,2011,Mar,64.8,59.7,698343,643153,55190,7.9,ME
75,2011,Apr,64.7,59.6,697858,643097,54761,7.8,ME
76,2011,May,64.7,59.6,697593,643030,54563,7.8,ME
77,2011,Jun,64.6,59.6,697688,643236,54452,7.8,ME
78,2011,Jul,64.7,59.6,698174,643935,54239,7.8,ME
79,2011,Aug,64.7,59.7,698915,645058,53857,7.7,ME
80,2011,Sep,64.8,59.8,699670,646382,53288,7.6,ME
81,2011,Oct,64.8,59.9,700205,647591,52614,7.5,ME
82,2011,Nov,64.8,60.0,700345,648450,51895,7.4,ME
83,2011,Dec,64.8,60.0,700108,648912,51196,7.3,ME
84,2012,Jan,64.7,60.0,699764,649142,50622,7.2,ME
85,2012,Feb,64.7,60.0,699615,649301,50314,7.2,ME
86,2012,Mar,64.7,60.0,699718,649374,50344,7.2,ME
87,2012,Apr,64.7,60.0,699864,649294,50570,7.2,ME
88,2012,May,64.7,60.0,700078,649263,50815,7.3,ME
89,2012,Jun,64.7,60.0,700348,649429,50919,7.3,ME
90,2012,Jul,64.7,60.0,700592,649809,50783,7.2,ME
91,2012,Aug,64.7,60.1,700906,650411,50495,7.2,ME
92,2012,Sep,64.8,60.1,701441,651204,50237,7.2,ME
93,2012,Oct,64.8,60.2,702058,652017,50041,7.1,ME
94,2012,Nov,64.8,60.2,702606,652681,49925,7.1,ME
95,2012,Dec,64.9,60.3,703024,653171,49853,7.1,ME
96,2013,Jan,64.9,60.3,703233,653477,49756,7.1,ME
97,2013,Feb,64.9,60.3,703337,653775,49562,7.0,ME
98,2013,Mar,64.9,60.4,703516,654325,49191,7.0,ME
99,2013,Apr,64.9,60.4,704005,655326,48679,6.9,ME
100,2013,May,65.0,60.6,704715,656605,48110,6.8,ME
101,2013,Jun,65.0,60.7,705441,657855,47586,6.7,ME
102,2013,Jul,65.1,60.7,705989,658878,47111,6.7,ME
103,2013,Aug,65.0,60.8,705978,659479,46499,6.6,ME
104,2013,Sep,65.0,60.7,705310,659610,45700,6.5,ME
105,2013,Oct,64.8,60.7,704366,659476,44890,6.4,ME
106,2013,Nov,64.7,60.7,703474,659283,44191,6.3,ME
107,2013,Dec,64.6,60.6,702632,659022,43610,6.2,ME
108,2014,Jan,64.5,60.6,701831,658792,43039,6.1,ME
109,2014,Feb,64.5,60.6,701068,658705,42363,6.0,ME
110,2014,Mar,64.4,60.5,700376,658761,41615,5.9,ME
111,2014,Apr,64.3,60.5,699680,658856,40824,5.8,ME
112,2014,May,64.2,60.5,698898,658932,39966,5.7,ME
113,2014,Jun,64.1,60.5,698129,659052,39077,5.6,ME
114,2014,Jul,64.0,60.5,697406,659150,38256,5.5,ME
115,2014,Aug,63.9,60.5,696893,659284,37609,5.4,ME
116,2014,Sep,63.9,60.5,696540,659456,37084,5.3,ME
117,2014,Oct,63.8,60.5,696052,659532,36520,5.2,ME
118,2014,Nov,63.7,60.5,695222,659414,35808,5.2,ME
119,2014,Dec,63.7,60.4,694247,659254,34993,5.0,ME
120,2015,Jan,63.6,60.4,693272,659092,34180,4.9,ME
121,2015,Feb,63.5,60.4,692242,658825,33417,4.8,ME
122,2015,Mar,63.4,60.4,691110,658472,32638,4.7,ME
123,2015,Apr,63.3,60.3,689909,658087,31822,4.6,ME
124,2015,May,63.1,60.3,688694,657703,30991,4.5,ME
125,2015,Jun,63.0,60.3,687442,657285,30157,4.4,ME
126,2015,Jul,62.9,60.2,686253,656874,29379,4.3,ME
127,2015,Aug,62.8,60.1,685224,656502,28722,4.2,ME
128,2015,Sep,62.7,60.1,684534,656347,28187,4.1,ME
129,2015,Oct,62.7,60.1,684485,656665,27820,4.1,ME
130,2015,Nov,62.7,60.2,685200,657554,27646,4.0,ME
131,2015,Dec,62.8,60.3,686446,658891,27555,4.0,ME
132,2016,Jan,62.9,60.4,687907,660486,27421,4.0,ME
133,2016,Feb,63.1,60.6,689398,662178,27220,3.9,ME
134,2016,Mar,63.2,60.7,690787,663837,26950,3.9,ME
135,2016,Apr,63.3,60.8,691999,665340,26659,3.9,ME
136,2016,May,63.4,60.9,693068,666646,26422,3.8,ME
137,2016,Jun,63.4,61.0,694036,667788,26248,3.8,ME
138,2016,Jul,63.5,61.1,694904,668817,26087,3.8,ME
139,2016,Aug,63.5,61.2,695716,669786,25930,3.7,ME
140,2016,Sep,63.6,61.2,696481,670673,25808,3.7,ME
141,2016,Oct,63.6,61.3,697115,671499,25616,3.7,ME
142,2016,Nov,63.6,61.3,697657,672408,25249,3.6,ME
143,2016,Dec,63.6,61.4,698186,673402,24784,3.5,ME
144,2017,Jan,63.7,61.4,702489,678066,24423,3.5,ME
145,2017,Feb,63.7,61.5,703204,679065,24139,3.4,ME
146,2017,Mar,63.7,61.6,703885,679879,24006,3.4,ME
147,2017,Apr,63.8,61.6,704512,680519,23993,3.4,ME
148,2017,May,63.8,61.6,705023,681002,24021,3.4,ME
149,2017,Jun,63.8,61.6,705310,681228,24082,3.4,ME
150,2017,Jul,63.8,61.6,705343,681199,24144,3.4,ME
151,2017,Aug,63.7,61.5,704992,680930,24062,3.4,ME
152,2017,Sep,63.6,61.4,704221,680467,23754,3.4,ME
153,2017,Oct,63.4,61.3,703145,679929,23216,3.3,ME
154,2017,Nov,63.3,61.3,701954,679429,22525,3.2,ME
155,2017,Dec,63.2,61.2,701023,679269,21754,3.1,ME
156,2018,Jan,63.1,61.2,700748,679668,21080,3.0,ME
157,2018,Feb,63.2,61.3,701368,680668,20700,3.0,ME
158,2018,Mar,63.3,61.4,702630,681958,20672,2.9,ME
159,2018,Apr,63.4,61.5,703934,682982,20952,3.0,ME
160,2018,May,63.4,61.5,704803,683346,21457,3.0,ME
161,2018,Jun,63.4,61.4,705076,683071,22005,3.1,ME
162,2018,Jul,63.3,61.3,704748,682283,22465,3.2,ME
163,2018,Aug,63.3,61.2,704124,681300,22824,3.2,ME
164,2018,Sep,63.1,61.1,703454,680450,23004,3.3,ME
165,2018,Oct,63.0,61.0,702840,679941,22899,3.3,ME
166,2018,Nov,63.0,60.9,702227,679752,22475,3.2,ME
167,2018,Dec,62.9,60.9,701527,679756,21771,3.1,ME
168,2019,Jan,62.8,60.9,700746,679839,20907,3.0,ME
169,2019,Feb,62.7,60.9,699945,679975,19970,2.9,ME
170,2019,Mar,62.6,60.9,699326,680236,19090,2.7,ME
171,2019,Apr,62.5,60.9,699231,680798,18433,2.6,ME
172,2019,May,62.6,60.9,699722,681599,18123,2.6,ME
173,2019,Jun,62.6,61.0,700654,682429,18225,2.6,ME
174,2019,Jul,62.7,61.0,701802,683119,18683,2.7,ME
175,2019,Aug,62.7,61.0,702886,683607,19279,2.7,ME
176,2019,Sep,62.8,61.0,703797,683997,19800,2.8,ME
177,2019,Oct,62.8,61.0,704453,684209,20244,2.9,ME
178,2019,Nov,62.7,60.9,704693,684140,20553,2.9,ME
179,2019,Dec,62.7,60.8,704071,683476,20595,2.9,ME
180,2020,Jan,62.5,60.7,702354,682099,20255,2.9,ME
181,2020,Feb,62.2,60.5,699661,680022,19639,2.8,ME
182,2020,Mar,61.9,60.2,696644,677777,18867,2.7,ME
183,2020,Apr,58.1,52.9,654532,595050,59482,9.1,ME
184,2020,May,59.5,54.0,669902,608388,61514,9.2,ME
185,2020,Jun,58.7,54.9,661340,617632,43708,6.6,ME
186,2020,Jul,59.4,55.6,668595,626400,42195,6.3,ME
187,2020,Aug,58.8,56.1,663228,632959,30269,4.6,ME
188,2020,Sep,59.2,56.6,668297,638750,29547,4.4,ME
189,2020,Oct,59.3,56.9,669712,642421,27291,4.1,ME
190,2020,Nov,59.5,57.1,673025,645188,27837,4.1,ME
191,2020,Dec,59.8,57.2,676567,647056,29511,4.4,ME
192,2021,Jan,59.9,57.3,678436,648314,30122,4.4,ME
193,2021,Feb,60.1,57.3,681004,649369,31635,4.6,ME
194,2021,Mar,60.2,57.4,682910,650402,32508,4.8,ME
195,2021,Apr,60.4,57.4,685101,651185,33916,5.0,ME
196,2021,May,60.3,57.4,684920,651674,33246,4.9,ME
197,2021,Jun,60.3,57.3,686042,651607,34435,5.0,ME
198,2021,Jul,60.1,57.2,684112,650928,33184,4.9,ME
199,2021,Aug,59.9,57.0,682786,650318,32468,4.8,ME
200,2021,Sep,59.6,56.9,680563,649896,30667,4.5,ME
201,2021,Oct,59.5,56.9,679766,649866,29900,4.4,ME
202,2021,Nov,59.3,56.8,678494,649850,28644,4.2,ME
203,2021,Dec,59.2,56.8,677998,649970,28028,4.1,ME
204,2022,Jan,59.3,56.8,679474,651293,28181,4.1,ME
205,2022,Feb,59.3,56.9,680015,653145,26870,4.0,ME
206,2022,Mar,59.2,57.0,679447,654684,24763,3.6,ME
207,2022,Apr,59.0,57.1,678788,656168,22620,3.3,ME
208,2022,May,59.0,57.1,679158,657635,21523,3.2,ME
209,2022,Jun,59.0,57.2,679967,659311,20656,3.0,ME
210,2022,Jul,58.8,57.2,678646,659329,19317,2.8,ME
211,2022,Aug,58.6,56.8,676897,655805,21092,3.1,ME
212,2022,Sep,58.4,56.5,675576,653449,22127,3.3,ME
213,2022,Oct,58.3,56.2,674613,650108,24505,3.6,ME
214,2022,Nov,58.0,55.9,672703,647735,24968,3.7,ME
0,2005,Jan,63.1,59.6,899441,849333,50108,5.6,NM
1,2005,Feb,63.1,59.6,901136,850853,50283,5.6,NM
2,2005,Mar,63.2,59.7,902610,852612,49998,5.5,NM
3,2005,Apr,63.2,59.7,903984,854724,49260,5.4,NM
4,2005,May,63.2,59.8,905359,857085,48274,5.3,NM
5,2005,Jun,63.2,59.9,906611,859291,47320,5.2,NM
6,2005,Jul,63.2,59.9,907701,861045,46656,5.1,NM
7,2005,Aug,63.1,59.9,908444,862259,46185,5.1,NM
8,2005,Sep,63.1,59.9,908796,863101,45695,5.0,NM
9,2005,Oct,62.9,59.8,908872,863955,44917,4.9,NM
10,2005,Nov,62.8,59.7,908755,865005,43750,4.8,NM
11,2005,Dec,62.6,59.7,908570,866249,42321,4.7,NM
12,2006,Jan,62.6,59.8,908699,867820,40879,4.5,NM
13,2006,Feb,62.5,59.8,909312,869623,39689,4.4,NM
14,2006,Mar,62.5,59.9,910354,871364,38990,4.3,NM
15,2006,Apr,62.6,59.9,911689,872848,38841,4.3,NM
16,2006,May,62.6,59.9,913119,874072,39047,4.3,NM
17,2006,Jun,62.6,59.9,914427,875099,39328,4.3,NM
18,2006,Jul,62.6,59.9,915559,876198,39361,4.3,NM
19,2006,Aug,62.6,59.9,916599,877554,39045,4.3,NM
20,2006,Sep,62.6,60.0,917536,879114,38422,4.2,NM
21,2006,Oct,62.6,60.0,918338,880849,37489,4.1,NM
22,2006,Nov,62.5,60.0,919054,882644,36410,4.0,NM
23,2006,Dec,62.5,60.1,919560,884218,35342,3.8,NM
24,2007,Jan,62.4,60.1,919697,885300,34397,3.7,NM
25,2007,Feb,62.3,60.0,919575,885908,33667,3.7,NM
26,2007,Mar,62.2,60.0,919257,886141,33116,3.6,NM
27,2007,Apr,62.1,59.9,918787,886126,32661,3.6,NM
28,2007,May,62.0,59.9,918348,886059,32289,3.5,NM
29,2007,Jun,61.9,59.8,918178,886182,31996,3.5,NM
30,2007,Jul,61.9,59.7,918496,886585,31911,3.5,NM
31,2007,Aug,61.9,59.7,919483,887348,32135,3.5,NM
32,2007,Sep,61.9,59.8,921102,888518,32584,3.5,NM
33,2007,Oct,62.0,59.8,923117,889896,33221,3.6,NM
34,2007,Nov,62.1,59.8,925216,891317,33899,3.7,NM
35,2007,Dec,62.2,59.9,927178,892693,34485,3.7,NM
36,2008,Jan,62.2,59.9,928742,893771,34971,3.8,NM
37,2008,Feb,62.3,59.9,929824,894455,35369,3.8,NM
38,2008,Mar,62.3,59.9,930563,894781,35782,3.8,NM
39,2008,Apr,62.3,59.8,931269,894875,36394,3.9,NM
40,2008,May,62.3,59.8,932259,894964,37295,4.0,NM
41,2008,Jun,62.3,59.8,933669,895203,38466,4.1,NM
42,2008,Jul,62.4,59.7,935197,895490,39707,4.2,NM
43,2008,Aug,62.4,59.7,936491,895498,40993,4.4,NM
44,2008,Sep,62.4,59.5,937279,894766,42513,4.5,NM
45,2008,Oct,62.3,59.4,937338,892860,44478,4.7,NM
46,2008,Nov,62.2,59.1,936604,889563,47041,5.0,NM
47,2008,Dec,62.1,58.7,935301,885097,50204,5.4,NM
48,2009,Jan,61.9,58.3,933823,879969,53854,5.8,NM
49,2009,Feb,61.8,57.9,932594,874843,57751,6.2,NM
50,2009,Mar,61.7,57.6,931934,870494,61440,6.6,NM
51,2009,Apr,61.6,57.4,931753,867304,64449,6.9,NM
52,2009,May,61.5,57.1,931475,864960,66515,7.1,NM
53,2009,Jun,61.4,57.0,930735,863044,67691,7.3,NM
54,2009,Jul,61.3,56.8,929397,861120,68277,7.3,NM
55,2009,Aug,61.1,56.6,927445,858923,68522,7.4,NM
56,2009,Sep,60.9,56.4,925248,856574,68674,7.4,NM
57,2009,Oct,60.7,56.1,923328,854347,68981,7.5,NM
58,2009,Nov,60.5,56.0,922350,852745,69605,7.5,NM
59,2009,Dec,60.5,55.9,922762,852174,70588,7.6,NM
60,2010,Jan,60.6,55.9,924482,852812,71670,7.8,NM
61,2010,Feb,60.7,55.9,926927,854371,72556,7.8,NM
62,2010,Mar,60.8,56.0,929410,856258,73152,7.9,NM
63,2010,Apr,59.5,54.8,931382,857944,73438,7.9,NM
64,2010,May,59.6,54.9,932501,859086,73415,7.9,NM
65,2010,Jun,59.5,54.8,932541,859355,73186,7.8,NM
66,2010,Jul,59.4,54.7,931590,858753,72837,7.8,NM
67,2010,Aug,59.2,54.6,930117,857660,72457,7.8,NM
68,2010,Sep,59.0,54.5,928535,856477,72058,7.8,NM
69,2010,Oct,58.9,54.4,927187,855710,71477,7.7,NM
70,2010,Nov,58.8,54.3,926179,855573,70606,7.6,NM
71,2010,Dec,58.7,54.3,925418,855971,69447,7.5,NM
72,2011,Jan,58.6,54.3,924865,856685,68180,7.4,NM
73,2011,Feb,58.6,54.3,924330,857362,66968,7.2,NM
74,2011,Mar,58.5,54.3,923689,857730,65959,7.1,NM
75,2011,Apr,58.4,54.3,923136,857741,65395,7.1,NM
76,2011,May,58.4,54.2,923007,857556,65451,7.1,NM
77,2011,Jun,58.3,54.2,923370,857388,65982,7.1,NM
78,2011,Jul,58.3,54.1,924204,857471,66733,7.2,NM
79,2011,Aug,58.4,54.1,925288,857828,67460,7.3,NM
80,2011,Sep,58.4,54.1,926262,858392,67870,7.3,NM
81,2011,Oct,58.4,54.1,927035,859120,67915,7.3,NM
82,2011,Nov,58.4,54.1,927454,859863,67591,7.3,NM
83,2011,Dec,58.4,54.2,927394,860484,66910,7.2,NM
84,2012,Jan,58.3,54.2,927044,861016,66028,7.1,NM
85,2012,Feb,58.3,54.2,926718,861491,65227,7.0,NM
86,2012,Mar,58.2,54.2,926490,861751,64739,7.0,NM
87,2012,Apr,58.2,54.2,926207,861707,64500,7.0,NM
88,2012,May,58.2,54.1,926085,861677,64408,7.0,NM
89,2012,Jun,58.2,54.1,926467,862094,64373,6.9,NM
90,2012,Jul,58.2,54.2,927463,863126,64337,6.9,NM
91,2012,Aug,58.3,54.2,928991,864648,64343,6.9,NM
92,2012,Sep,58.4,54.3,930861,866333,64528,6.9,NM
93,2012,Oct,58.4,54.4,932379,867580,64799,6.9,NM
94,2012,Nov,58.4,54.4,933099,868064,65035,7.0,NM
95,2012,Dec,58.4,54.3,933029,867842,65187,7.0,NM
96,2013,Jan,58.3,54.3,932257,867056,65201,7.0,NM
97,2013,Feb,58.2,54.2,931106,866088,65018,7.0,NM
98,2013,Mar,58.2,54.1,930071,865458,64613,6.9,NM
99,2013,Apr,58.1,54.1,929563,865440,64123,6.9,NM
100,2013,May,58.1,54.1,929480,865698,63782,6.9,NM
101,2013,Jun,58.1,54.1,929499,865780,63719,6.9,NM
102,2013,Jul,58.0,54.0,929444,865549,63895,6.9,NM
103,2013,Aug,58.0,54.0,929189,865146,64043,6.9,NM
104,2013,Sep,58.0,54.0,928819,864817,64002,6.9,NM
105,2013,Oct,57.9,54.0,928678,864770,63908,6.9,NM
106,2013,Nov,57.9,54.0,928846,865040,63806,6.9,NM
107,2013,Dec,57.9,54.0,929082,865489,63593,6.8,NM
108,2014,Jan,57.9,54.0,929249,866039,63210,6.8,NM
109,2014,Feb,58.0,54.0,929329,866611,62718,6.7,NM
110,2014,Mar,58.0,54.1,929411,867098,62313,6.7,NM
111,2014,Apr,58.0,54.1,929509,867421,62088,6.7,NM
112,2014,May,58.0,54.1,929764,867859,61905,6.7,NM
113,2014,Jun,58.0,54.2,930470,868766,61704,6.6,NM
114,2014,Jul,58.1,54.2,931549,870102,61447,6.6,NM
115,2014,Aug,58.1,54.3,932840,871735,61105,6.6,NM
116,2014,Sep,58.2,54.4,934149,873427,60722,6.5,NM
117,2014,Oct,58.2,54.5,935256,874941,60315,6.4,NM
118,2014,Nov,58.2,54.5,936040,876027,60013,6.4,NM
119,2014,Dec,58.3,54.5,936723,876625,60098,6.4,NM
120,2015,Jan,58.3,54.5,937449,876798,60651,6.5,NM
121,2015,Feb,58.3,54.5,938267,876702,61565,6.6,NM
122,2015,Mar,58.4,54.5,939088,876587,62501,6.7,NM
123,2015,Apr,58.4,54.5,939710,876589,63121,6.7,NM
124,2015,May,58.4,54.5,939838,876592,63246,6.7,NM
125,2015,Jun,58.3,54.4,939351,876434,62917,6.7,NM
126,2015,Jul,58.3,54.4,938492,876122,62370,6.6,NM
127,2015,Aug,58.2,54.3,937602,875731,61871,6.6,NM
128,2015,Sep,58.1,54.3,936945,875502,61443,6.6,NM
129,2015,Oct,58.1,54.3,936887,875740,61147,6.5,NM
130,2015,Nov,58.1,54.3,937588,876509,61079,6.5,NM
131,2015,Dec,58.2,54.4,938775,877628,61147,6.5,NM
132,2016,Jan,58.2,54.4,940030,878770,61260,6.5,NM
133,2016,Feb,58.3,54.5,941120,879654,61466,6.5,NM
134,2016,Mar,58.3,54.5,941995,880148,61847,6.6,NM
135,2016,Apr,58.3,54.5,942848,880344,62504,6.6,NM
136,2016,May,58.4,54.5,943841,880426,63415,6.7,NM
137,2016,Jun,58.4,54.4,944847,880481,64366,6.8,NM
138,2016,Jul,58.5,54.4,945687,880580,65107,6.9,NM
139,2016,Aug,58.5,54.4,946277,880730,65547,6.9,NM
140,2016,Sep,58.5,54.4,946531,880785,65746,6.9,NM
141,2016,Oct,58.4,54.4,946423,880745,65678,6.9,NM
142,2016,Nov,58.4,54.4,946214,880917,65297,6.9,NM
143,2016,Dec,58.4,54.4,946205,881536,64669,6.8,NM
144,2017,Jan,58.4,54.4,948436,884417,64019,6.7,NM
145,2017,Feb,58.4,54.5,949289,886194,63095,6.6,NM
146,2017,Mar,58.5,54.6,950051,888083,61968,6.5,NM
147,2017,Apr,58.5,54.7,950523,889828,60695,6.4,NM
148,2017,May,58.5,54.8,950564,891259,59305,6.2,NM
149,2017,Jun,58.4,54.9,950091,892199,57892,6.1,NM
150,2017,Jul,58.3,54.9,949257,892654,56603,6.0,NM
151,2017,Aug,58.3,54.8,948194,892747,55447,5.8,NM
152,2017,Sep,58.2,54.8,947109,892724,54385,5.7,NM
153,2017,Oct,58.1,54.8,946178,892867,53311,5.6,NM
154,2017,Nov,58.0,54.8,945481,893299,52182,5.5,NM
155,2017,Dec,58.0,54.8,945193,894267,50926,5.4,NM
156,2018,Jan,58.0,54.9,945574,895943,49631,5.2,NM
157,2018,Feb,58.0,55.1,946700,898319,48381,5.1,NM
158,2018,Mar,58.1,55.2,948232,901035,47197,5.0,NM
159,2018,Apr,58.2,55.3,949515,903412,46103,4.9,NM
160,2018,May,58.2,55.4,950167,904933,45234,4.8,NM
161,2018,Jun,58.2,55.4,950210,905561,44649,4.7,NM
162,2018,Jul,58.1,55.4,949860,905474,44386,4.7,NM
163,2018,Aug,58.1,55.3,949718,905087,44631,4.7,NM
164,2018,Sep,58.1,55.3,950335,904849,45486,4.8,NM
165,2018,Oct,58.1,55.3,951879,905123,46756,4.9,NM
166,2018,Nov,58.2,55.3,954150,906055,48095,5.0,NM
167,2018,Dec,58.3,55.3,956681,907546,49135,5.1,NM
168,2019,Jan,58.5,55.4,958921,909271,49650,5.2,NM
169,2019,Feb,58.5,55.5,960554,910972,49582,5.2,NM
170,2019,Mar,58.6,55.6,961674,912522,49152,5.1,NM
171,2019,Apr,58.6,55.6,962443,913981,48462,5.0,NM
172,2019,May,58.6,55.7,962898,915298,47600,4.9,NM
173,2019,Jun,58.6,55.7,963094,916379,46715,4.9,NM
174,2019,Jul,58.5,55.7,963191,917170,46021,4.8,NM
175,2019,Aug,58.5,55.7,963480,917845,45635,4.7,NM
176,2019,Sep,58.5,55.7,964356,918805,45551,4.7,NM
177,2019,Oct,58.6,55.8,966060,919906,46154,4.8,NM
178,2019,Nov,58.7,55.8,968291,920799,47492,4.9,NM
179,2019,Dec,58.7,55.7,970090,920861,49229,5.1,NM
180,2020,Jan,58.7,55.6,970631,919774,50857,5.2,NM
181,2020,Feb,58.6,55.5,969579,917617,51962,5.4,NM
182,2020,Mar,57.8,54.3,956071,898213,57858,6.1,NM
183,2020,Apr,54.4,49.2,901008,815040,85968,9.5,NM
184,2020,May,54.6,49.3,903911,815581,88330,9.8,NM
185,2020,Jun,54.5,49.3,902328,816289,86039,9.5,NM
186,2020,Jul,54.7,49.5,907059,819919,87140,9.6,NM
187,2020,Aug,54.7,49.6,906366,822282,84084,9.3,NM
188,2020,Sep,57.8,52.7,958094,873440,84654,8.8,NM
189,2020,Oct,57.4,52.6,953379,873742,79637,8.4,NM
190,2020,Nov,57.2,52.6,949234,872941,76293,8.0,NM
191,2020,Dec,57.0,52.5,946024,871535,74489,7.9,NM
192,2021,Jan,56.6,52.4,940257,870330,69927,7.4,NM
193,2021,Feb,56.5,52.4,938825,870109,68716,7.3,NM
194,2021,Mar,56.5,52.4,939497,871422,68075,7.2,NM
195,2021,Apr,56.7,52.6,942801,873739,69062,7.3,NM
196,2021,May,56.8,52.7,943858,876160,67698,7.2,NM
197,2021,Jun,56.9,52.8,947030,878205,68825,7.3,NM
198,2021,Jul,56.8,52.9,946148,879924,66224,7.0,NM
199,2021,Aug,56.8,53.0,945864,881924,63940,6.8,NM
200,2021,Sep,56.6,53.0,942724,883961,58763,6.2,NM
201,2021,Oct,56.6,53.1,943509,886073,57436,6.1,NM
202,2021,Nov,56.5,53.1,942721,886487,56234,6.0,NM
203,2021,Dec,56.4,53.1,941516,886415,55101,5.9,NM
204,2022,Jan,56.6,53.2,944728,889293,55435,5.9,NM
205,2022,Feb,56.7,53.5,947443,894325,53118,5.6,NM
206,2022,Mar,56.7,53.7,948239,897881,50358,5.3,NM
207,2022,Apr,56.8,53.8,949673,899603,50070,5.3,NM
208,2022,May,56.9,54.0,951838,903535,48303,5.1,NM
209,2022,Jun,56.9,54.2,952712,906325,46387,4.9,NM
210,2022,Jul,56.7,54.1,948930,906636,42294,4.5,NM
211,2022,Aug,56.5,54.0,946604,904783,41821,4.4,NM
212,2022,Sep,56.3,53.9,943696,903665,40031,4.2,NM
213,2022,Oct,56.1,53.7,941675,901526,40149,4.3,NM
214,2022,Nov,56.0,53.7,939546,901442,38104,4.1,NM
0,2005,Jan,61.8,58.4,1971250,1863475,107775,5.5,KY
1,2005,Feb,61.8,58.4,1975095,1864921,110174,5.6,KY
2,2005,Mar,61.9,58.4,1979166,1867008,112158,5.7,KY
3,2005,Apr,62.0,58.5,1983363,1869854,113509,5.7,KY
4,2005,May,62.1,58.5,1987665,1873238,114427,5.8,KY
5,2005,Jun,62.2,58.6,1991854,1876503,115351,5.8,KY
6,2005,Jul,62.2,58.6,1995787,1878884,116903,5.9,KY
7,2005,Aug,62.3,58.6,1999069,1880045,119024,6.0,KY
8,2005,Sep,62.3,58.5,2001269,1880085,121184,6.1,KY
9,2005,Oct,62.2,58.4,2002716,1879980,122736,6.1,KY
10,2005,Nov,62.2,58.3,2003954,1880622,123332,6.2,KY
11,2005,Dec,62.1,58.3,2005232,1882447,122785,6.1,KY
12,2006,Jan,62.1,58.4,2006831,1885679,121152,6.0,KY
13,2006,Feb,62.1,58.5,2008797,1889872,118925,5.9,KY
14,2006,Mar,62.2,58.5,2011065,1894196,116869,5.8,KY
15,2006,Apr,62.2,58.6,2013756,1898114,115642,5.7,KY
16,2006,May,62.2,58.7,2017039,1901829,115210,5.7,KY
17,2006,Jun,62.3,58.7,2020968,1905580,115388,5.7,KY
18,2006,Jul,62.4,58.8,2025779,1910088,115691,5.7,KY
19,2006,Aug,62.5,58.9,2031652,1915782,115870,5.7,KY
20,2006,Sep,62.6,59.1,2038086,1922152,115934,5.7,KY
21,2006,Oct,62.8,59.2,2043869,1928275,115594,5.7,KY
22,2006,Nov,62.9,59.3,2047981,1933255,114726,5.6,KY
23,2006,Dec,62.9,59.4,2049777,1936376,113401,5.5,KY
24,2007,Jan,62.8,59.4,2049214,1937338,111876,5.5,KY
25,2007,Feb,62.7,59.3,2046911,1936545,110366,5.4,KY
26,2007,Mar,62.6,59.2,2043296,1934313,108983,5.3,KY
27,2007,Apr,62.4,59.1,2039096,1931178,107918,5.3,KY
28,2007,May,62.2,59.0,2035221,1927722,107499,5.3,KY
29,2007,Jun,62.1,58.8,2032318,1924641,107677,5.3,KY
30,2007,Jul,62.0,58.7,2030626,1922179,108447,5.3,KY
31,2007,Aug,61.9,58.6,2030101,1920430,109671,5.4,KY
32,2007,Sep,61.9,58.5,2030322,1919801,110521,5.4,KY
33,2007,Oct,61.8,58.5,2030463,1919867,110596,5.4,KY
34,2007,Nov,61.7,58.4,2029895,1919969,109926,5.4,KY
35,2007,Dec,61.7,58.3,2028679,1919790,108889,5.4,KY
36,2008,Jan,61.6,58.3,2027269,1919001,108268,5.3,KY
37,2008,Feb,61.5,58.2,2026297,1917658,108639,5.4,KY
38,2008,Mar,61.4,58.1,2026753,1916245,110508,5.5,KY
39,2008,Apr,61.5,58.0,2028938,1914843,114095,5.6,KY
40,2008,May,61.5,57.9,2032389,1913311,119078,5.9,KY
41,2008,Jun,61.6,57.8,2036392,1911585,124807,6.1,KY
42,2008,Jul,61.6,57.7,2040031,1909387,130644,6.4,KY
43,2008,Aug,61.7,57.5,2042938,1906189,136749,6.7,KY
44,2008,Sep,61.7,57.4,2045566,1901351,144215,7.1,KY
45,2008,Oct,61.8,57.1,2048791,1894862,153929,7.5,KY
46,2008,Nov,61.9,56.9,2052892,1886996,165896,8.1,KY
47,2008,Dec,62.0,56.6,2057610,1878114,179496,8.7,KY
48,2009,Jan,62.1,56.3,2062601,1868875,193726,9.4,KY
49,2009,Feb,62.2,56.0,2067583,1860303,207280,10.0,KY
50,2009,Mar,62.4,55.8,2071976,1853366,218610,10.6,KY
51,2009,Apr,62.4,55.6,2074923,1848460,226463,10.9,KY
52,2009,May,62.4,55.5,2075708,1844941,230767,11.1,KY
53,2009,Jun,62.4,55.4,2074132,1841907,232225,11.2,KY
54,2009,Jul,62.2,55.3,2070370,1838771,231599,11.2,KY
55,2009,Aug,62.0,55.1,2064926,1835411,229515,11.1,KY
56,2009,Sep,61.8,55.0,2059145,1832168,226977,11.0,KY
57,2009,Oct,61.6,54.8,2054515,1829565,224950,10.9,KY
58,2009,Nov,61.5,54.8,2052571,1828591,223980,10.9,KY
59,2009,Dec,61.5,54.8,2053885,1829926,223959,10.9,KY
60,2010,Jan,61.5,54.8,2057265,1833428,223837,10.9,KY
61,2010,Feb,61.6,55.0,2060696,1838044,222652,10.8,KY
62,2010,Mar,61.6,55.1,2062897,1842725,220172,10.7,KY
63,2010,Apr,61.8,55.3,2063774,1847055,216719,10.5,KY
64,2010,May,61.7,55.4,2063716,1851019,212697,10.3,KY
65,2010,Jun,61.6,55.4,2063356,1854264,209092,10.1,KY
66,2010,Jul,61.6,55.4,2063585,1856614,206971,10.0,KY
67,2010,Aug,61.6,55.4,2064904,1858381,206523,10.0,KY
68,2010,Sep,61.6,55.4,2066702,1859754,206948,10.0,KY
69,2010,Oct,61.6,55.4,2068269,1861137,207132,10.0,KY
70,2010,Nov,61.6,55.5,2069007,1862657,206350,10.0,KY
71,2010,Dec,61.6,55.5,2068709,1864297,204412,9.9,KY
72,2011,Jan,61.5,55.5,2067917,1866158,201759,9.8,KY
73,2011,Feb,61.4,55.5,2066889,1867770,199119,9.6,KY
74,2011,Mar,61.4,55.5,2065391,1868492,196899,9.5,KY
75,2011,Apr,61.3,55.5,2063457,1867982,195475,9.5,KY
76,2011,May,61.2,55.4,2061619,1866520,195099,9.5,KY
77,2011,Jun,61.1,55.3,2060245,1865052,195193,9.5,KY
78,2011,Jul,61.1,55.3,2059549,1864549,195000,9.5,KY
79,2011,Aug,61.0,55.3,2059402,1865360,194042,9.4,KY
80,2011,Sep,61.0,55.3,2059397,1867511,191886,9.3,KY
81,2011,Oct,61.0,55.4,2058960,1870409,188551,9.2,KY
82,2011,Nov,60.9,55.4,2057306,1873049,184257,9.0,KY
83,2011,Dec,60.8,55.5,2054336,1874902,179434,8.7,KY
84,2012,Jan,60.7,55.5,2050998,1876189,174809,8.5,KY
85,2012,Feb,60.6,55.5,2048659,1877591,171068,8.4,KY
86,2012,Mar,60.5,55.5,2048252,1879434,168818,8.2,KY
87,2012,Apr,60.6,55.6,2049721,1881638,168083,8.2,KY
88,2012,May,60.6,55.7,2052837,1884530,168307,8.2,KY
89,2012,Jun,60.7,55.7,2057041,1888219,168822,8.2,KY
90,2012,Jul,60.8,55.8,2061588,1892555,169033,8.2,KY
91,2012,Aug,60.9,55.9,2065968,1897095,168873,8.2,KY
92,2012,Sep,61.0,56.0,2069786,1901222,168564,8.1,KY
93,2012,Oct,61.0,56.1,2072317,1904250,168067,8.1,KY
94,2012,Nov,61.0,56.1,2073384,1905934,167450,8.1,KY
95,2012,Dec,61.0,56.1,2072953,1906182,166771,8.0,KY
96,2013,Jan,60.9,56.0,2071047,1904810,166237,8.0,KY
97,2013,Feb,60.8,55.9,2068320,1902317,166003,8.0,KY
98,2013,Mar,60.7,55.8,2065701,1899808,165893,8.0,KY
99,2013,Apr,60.6,55.7,2064135,1898417,165718,8.0,KY
100,2013,May,60.5,55.7,2063352,1897711,165641,8.0,KY
101,2013,Jun,60.5,55.6,2062469,1896774,165695,8.0,KY
102,2013,Jul,60.4,55.5,2060497,1894998,165499,8.0,KY
103,2013,Aug,60.2,55.4,2056498,1892207,164291,8.0,KY
104,2013,Sep,60.0,55.3,2050680,1888658,162022,7.9,KY
105,2013,Oct,59.8,55.2,2044372,1884947,159425,7.8,KY
106,2013,Nov,59.6,55.0,2038670,1881766,156904,7.7,KY
107,2013,Dec,59.5,55.0,2034084,1879552,154532,7.6,KY
108,2014,Jan,59.4,54.9,2030616,1878659,151957,7.5,KY
109,2014,Feb,59.3,54.9,2027674,1878905,148769,7.3,KY
110,2014,Mar,59.1,54.9,2024499,1879447,145052,7.2,KY
111,2014,Apr,59.0,54.9,2020074,1879242,140832,7.0,KY
112,2014,May,58.8,54.8,2014317,1878442,135875,6.7,KY
113,2014,Jun,58.6,54.8,2008207,1877753,130454,6.5,KY
114,2014,Jul,58.4,54.8,2002336,1877122,125214,6.3,KY
115,2014,Aug,58.2,54.7,1997344,1876646,120698,6.0,KY
116,2014,Sep,58.1,54.7,1993235,1876403,116832,5.9,KY
117,2014,Oct,58.0,54.7,1989610,1876386,113224,5.7,KY
118,2014,Nov,57.8,54.6,1986279,1876349,109930,5.5,KY
119,2014,Dec,57.7,54.6,1983555,1876205,107350,5.4,KY
120,2015,Jan,57.7,54.6,1981477,1875886,105591,5.3,KY
121,2015,Feb,57.6,54.6,1979937,1875247,104690,5.3,KY
122,2015,Mar,57.5,54.5,1978823,1874526,104297,5.3,KY
123,2015,Apr,57.5,54.5,1977936,1873917,104019,5.3,KY
124,2015,May,57.5,54.4,1976817,1873250,103567,5.2,KY
125,2015,Jun,57.4,54.4,1975226,1872397,102829,5.2,KY
126,2015,Jul,57.3,54.4,1974094,1871994,102100,5.2,KY
127,2015,Aug,57.3,54.3,1974414,1872627,101787,5.2,KY
128,2015,Sep,57.3,54.4,1976725,1874730,101995,5.2,KY
129,2015,Oct,57.4,54.5,1981083,1878391,102692,5.2,KY
130,2015,Nov,57.6,54.6,1986651,1883128,103523,5.2,KY
131,2015,Dec,57.7,54.7,1992217,1888233,103984,5.2,KY
132,2016,Jan,57.8,54.8,1996889,1893069,103820,5.2,KY
133,2016,Feb,57.9,54.9,2000307,1897358,102949,5.1,KY
134,2016,Mar,58.0,55.0,2002784,1901323,101461,5.1,KY
135,2016,Apr,58.0,55.1,2005178,1905194,99984,5.0,KY
136,2016,May,58.1,55.2,2008503,1909307,99196,4.9,KY
137,2016,Jun,58.2,55.3,2012869,1913680,99189,4.9,KY
138,2016,Jul,58.3,55.4,2017591,1917963,99628,4.9,KY
139,2016,Aug,58.4,55.5,2022067,1921669,100398,5.0,KY
140,2016,Sep,58.5,55.6,2026061,1924543,101518,5.0,KY
141,2016,Oct,58.6,55.6,2029535,1926913,102622,5.1,KY
142,2016,Nov,58.6,55.7,2033028,1929665,103363,5.1,KY
143,2016,Dec,58.7,55.7,2036870,1933310,103560,5.1,KY
144,2017,Jan,58.7,55.7,2044263,1940528,103735,5.1,KY
145,2017,Feb,58.8,55.8,2048540,1945461,103079,5.0,KY
146,2017,Mar,58.9,55.9,2052277,1949728,102549,5.0,KY
147,2017,Apr,58.9,56.0,2055149,1953059,102090,5.0,KY
148,2017,May,59.0,56.1,2056962,1955520,101442,4.9,KY
149,2017,Jun,59.0,56.1,2057642,1957047,100595,4.9,KY
150,2017,Jul,58.9,56.1,2057506,1958016,99490,4.8,KY
151,2017,Aug,58.9,56.1,2056456,1958734,97722,4.8,KY
152,2017,Sep,58.8,56.1,2054594,1959273,95321,4.6,KY
153,2017,Oct,58.7,56.1,2052327,1959688,92639,4.5,KY
154,2017,Nov,58.6,56.1,2050175,1960040,90135,4.4,KY
155,2017,Dec,58.6,56.1,2048835,1960723,88112,4.3,KY
156,2018,Jan,58.6,56.1,2049084,1962252,86832,4.2,KY
157,2018,Feb,58.7,56.2,2051455,1965154,86301,4.2,KY
158,2018,Mar,58.7,56.3,2055144,1968939,86205,4.2,KY
159,2018,Apr,58.8,56.4,2058416,1972112,86304,4.2,KY
160,2018,May,58.9,56.4,2059982,1973366,86616,4.2,KY
161,2018,Jun,58.8,56.3,2059666,1972763,86903,4.2,KY
162,2018,Jul,58.8,56.3,2057693,1970705,86988,4.2,KY
163,2018,Aug,58.7,56.2,2055112,1968146,86966,4.2,KY
164,2018,Sep,58.6,56.1,2052961,1966105,86856,4.2,KY
165,2018,Oct,58.5,56.0,2051950,1965308,86642,4.2,KY
166,2018,Nov,58.5,56.0,2052205,1965860,86345,4.2,KY
167,2018,Dec,58.5,56.1,2053606,1967669,85937,4.2,KY
168,2019,Jan,58.6,56.1,2055558,1970220,85338,4.2,KY
169,2019,Feb,58.6,56.2,2057631,1973009,84622,4.1,KY
170,2019,Mar,58.7,56.3,2060181,1975939,84242,4.1,KY
171,2019,Apr,58.8,56.4,2063421,1979188,84233,4.1,KY
172,2019,May,58.8,56.4,2066906,1982623,84283,4.1,KY
173,2019,Jun,58.9,56.5,2070361,1985921,84440,4.1,KY
174,2019,Jul,59.0,56.6,2073616,1988940,84676,4.1,KY
175,2019,Aug,59.0,56.6,2076407,1991685,84722,4.1,KY
176,2019,Sep,59.1,56.7,2078633,1994444,84189,4.1,KY
177,2019,Oct,59.1,56.7,2080189,1996711,83478,4.0,KY
178,2019,Nov,59.1,56.7,2080572,1997565,83007,4.0,KY
179,2019,Dec,59.0,56.7,2078609,1995555,83054,4.0,KY
180,2020,Jan,58.9,56.5,2073850,1990176,83674,4.0,KY
181,2020,Feb,58.6,56.2,2066228,1981930,84298,4.1,KY
182,2020,Mar,58.4,56.0,2056888,1972811,84077,4.1,KY
183,2020,Apr,58.0,48.5,2046205,1707956,338249,16.5,KY
184,2020,May,58.4,51.0,2057172,1798465,258707,12.6,KY
185,2020,Jun,54.7,51.9,1928098,1829351,98747,5.1,KY
186,2020,Jul,55.9,52.7,1969308,1857850,111458,5.7,KY
187,2020,Aug,56.2,53.3,1981356,1878959,102397,5.2,KY
188,2020,Sep,56.6,53.8,1996370,1895377,100993,5.1,KY
189,2020,Oct,56.8,54.0,2003161,1904902,98259,4.9,KY
190,2020,Nov,56.9,54.2,2008645,1910583,98062,4.9,KY
191,2020,Dec,57.0,54.3,2012427,1914712,97715,4.9,KY
192,2021,Jan,57.1,54.4,2014892,1918828,96064,4.8,KY
193,2021,Feb,57.2,54.5,2018582,1923746,94836,4.7,KY
194,2021,Mar,57.3,54.7,2023506,1929115,94391,4.7,KY
195,2021,Apr,57.5,54.8,2028238,1933468,94770,4.7,KY
196,2021,May,57.6,54.9,2032018,1936506,95512,4.7,KY
197,2021,Jun,57.6,54.9,2035462,1938228,97234,4.8,KY
198,2021,Jul,57.7,54.9,2038826,1940562,98264,4.8,KY
199,2021,Aug,57.8,55.0,2042295,1944140,98155,4.8,KY
200,2021,Sep,57.8,55.1,2046111,1949282,96829,4.7,KY
201,2021,Oct,57.9,55.2,2049746,1954511,95235,4.6,KY
202,2021,Nov,57.9,55.3,2050970,1956869,94101,4.6,KY
203,2021,Dec,57.9,55.3,2051251,1957530,93721,4.6,KY
204,2022,Jan,58.0,55.4,2054057,1963312,90745,4.4,KY
205,2022,Feb,58.0,55.6,2056085,1969585,86500,4.2,KY
206,2022,Mar,58.1,55.8,2060196,1977947,82249,4.0,KY
207,2022,Apr,58.1,55.9,2062849,1982987,79862,3.9,KY
208,2022,May,58.2,56.0,2064828,1985824,79004,3.8,KY
209,2022,Jun,58.1,55.9,2064228,1986905,77323,3.7,KY
210,2022,Jul,58.1,55.9,2063623,1986488,77135,3.7,KY
211,2022,Aug,58.0,55.8,2062996,1984704,78292,3.8,KY
212,2022,Sep,58.0,55.8,2062061,1983883,78178,3.8,KY
213,2022,Oct,57.9,55.6,2060124,1979855,80269,3.9,KY
214,2022,Nov,57.7,55.4,2055608,1973298,82310,4.0,KY
0,2005,Jan,71.1,68.5,720535,694605,25930,3.6,NH
1,2005,Feb,71.1,68.6,721899,695698,26201,3.6,NH
2,2005,Mar,71.2,68.6,723194,696902,26292,3.6,NH
3,2005,Apr,71.3,68.7,724404,698177,26227,3.6,NH
4,2005,May,71.3,68.7,725551,699419,26132,3.6,NH
5,2005,Jun,71.3,68.8,726590,700432,26158,3.6,NH
6,2005,Jul,71.4,68.8,727494,701103,26391,3.6,NH
7,2005,Aug,71.3,68.7,728165,701451,26714,3.7,NH
8,2005,Sep,71.3,68.7,728538,701605,26933,3.7,NH
9,2005,Oct,71.2,68.5,728681,701803,26878,3.7,NH
10,2005,Nov,71.1,68.5,728637,702098,26539,3.6,NH
11,2005,Dec,71.0,68.5,728390,702402,25988,3.6,NH
12,2006,Jan,70.9,68.4,728153,702807,25346,3.5,NH
13,2006,Feb,70.8,68.4,728227,703407,24820,3.4,NH
14,2006,Mar,70.8,68.4,728692,704087,24605,3.4,NH
15,2006,Apr,70.8,68.4,729434,704706,24728,3.4,NH
16,2006,May,70.8,68.4,730385,705339,25046,3.4,NH
17,2006,Jun,70.9,68.4,731464,706031,25433,3.5,NH
18,2006,Jul,70.9,68.4,732649,706839,25810,3.5,NH
19,2006,Aug,71.0,68.4,733885,707684,26201,3.6,NH
20,2006,Sep,71.0,68.5,735101,708478,26623,3.6,NH
21,2006,Oct,71.1,68.5,736259,709278,26981,3.7,NH
22,2006,Nov,71.1,68.5,737245,710011,27234,3.7,NH
23,2006,Dec,71.1,68.5,737892,710530,27362,3.7,NH
24,2007,Jan,71.1,68.4,738127,710750,27377,3.7,NH
25,2007,Feb,71.0,68.4,738051,710769,27282,3.7,NH
26,2007,Mar,70.9,68.3,737807,710760,27047,3.7,NH
27,2007,Apr,70.9,68.3,737554,710853,26701,3.6,NH
28,2007,May,70.8,68.3,737348,711043,26305,3.6,NH
29,2007,Jun,70.7,68.2,737196,711311,25885,3.5,NH
30,2007,Jul,70.7,68.2,737155,711665,25490,3.5,NH
31,2007,Aug,70.6,68.2,737376,712204,25172,3.4,NH
32,2007,Sep,70.6,68.2,737902,712965,24937,3.4,NH
33,2007,Oct,70.6,68.3,738556,713731,24825,3.4,NH
34,2007,Nov,70.6,68.3,739282,714482,24800,3.4,NH
35,2007,Dec,70.7,68.3,740089,715268,24821,3.4,NH
36,2008,Jan,70.7,68.3,740860,715950,24910,3.4,NH
37,2008,Feb,70.7,68.3,741503,716454,25049,3.4,NH
38,2008,Mar,70.7,68.3,742078,716778,25300,3.4,NH
39,2008,Apr,70.8,68.3,742699,716980,25719,3.5,NH
40,2008,May,70.8,68.3,743388,717095,26293,3.5,NH
41,2008,Jun,70.8,68.2,744061,717107,26954,3.6,NH
42,2008,Jul,70.8,68.1,744446,716847,27599,3.7,NH
43,2008,Aug,70.7,68.0,744390,716147,28243,3.8,NH
44,2008,Sep,70.7,67.9,743962,714905,29057,3.9,NH
45,2008,Oct,70.6,67.7,743369,713113,30256,4.1,NH
46,2008,Nov,70.5,67.4,742758,710772,31986,4.3,NH
47,2008,Dec,70.4,67.1,742265,708028,34237,4.6,NH
48,2009,Jan,70.3,66.8,741908,705050,36858,5.0,NH
49,2009,Feb,70.3,66.5,741687,702099,39588,5.3,NH
50,2009,Mar,70.3,66.3,741588,699527,42061,5.7,NH
51,2009,Apr,70.2,66.0,741426,697402,44024,5.9,NH
52,2009,May,70.1,65.8,741008,695549,45459,6.1,NH
53,2009,Jun,70.1,65.7,740388,693929,46459,6.3,NH
54,2009,Jul,70.0,65.5,739675,692510,47165,6.4,NH
55,2009,Aug,69.8,65.3,738881,691170,47711,6.5,NH
56,2009,Sep,69.7,65.2,738126,689936,48190,6.5,NH
57,2009,Oct,69.6,65.0,737634,688986,48648,6.6,NH
58,2009,Nov,69.6,65.0,737602,688535,49067,6.7,NH
59,2009,Dec,69.6,65.0,738068,688711,49357,6.7,NH
60,2010,Jan,69.7,65.0,738872,689553,49319,6.7,NH
61,2010,Feb,69.7,65.1,739669,690835,48834,6.6,NH
62,2010,Mar,69.8,65.2,740166,692203,47963,6.5,NH
63,2010,Apr,70.4,65.9,740408,693597,46811,6.3,NH
64,2010,May,70.4,66.0,740470,694958,45512,6.1,NH
65,2010,Jun,70.3,66.1,740293,695944,44349,6.0,NH
66,2010,Jul,70.3,66.1,739936,696361,43575,5.9,NH
67,2010,Aug,70.2,66.1,739536,696314,43222,5.8,NH
68,2010,Sep,70.1,66.0,739060,695941,43119,5.8,NH
69,2010,Oct,70.0,65.9,738460,695479,42981,5.8,NH
70,2010,Nov,69.9,65.8,737754,695164,42590,5.8,NH
71,2010,Dec,69.8,65.8,737034,695099,41935,5.7,NH
72,2011,Jan,69.7,65.8,736494,695308,41186,5.6,NH
73,2011,Feb,69.6,65.8,736127,695593,40534,5.5,NH
74,2011,Mar,69.6,65.8,735804,695715,40089,5.4,NH
75,2011,Apr,69.5,65.7,735460,695495,39965,5.4,NH
76,2011,May,69.4,65.6,735189,695005,40184,5.5,NH
77,2011,Jun,69.4,65.6,735206,694662,40544,5.5,NH
78,2011,Jul,69.4,65.5,735661,694880,40781,5.5,NH
79,2011,Aug,69.4,65.6,736515,695779,40736,5.5,NH
80,2011,Sep,69.5,65.7,737544,697156,40388,5.5,NH
81,2011,Oct,69.5,65.7,738453,698579,39874,5.4,NH
82,2011,Nov,69.5,65.8,738938,699618,39320,5.3,NH
83,2011,Dec,69.4,65.8,738885,700072,38813,5.3,NH
84,2012,Jan,69.4,65.7,738518,700039,38479,5.2,NH
85,2012,Feb,69.3,65.7,738232,699770,38462,5.2,NH
86,2012,Mar,69.2,65.6,738277,699419,38858,5.3,NH
87,2012,Apr,69.2,65.5,738620,699082,39538,5.4,NH
88,2012,May,69.2,65.5,739300,699017,40283,5.4,NH
89,2012,Jun,69.3,65.5,740199,699309,40890,5.5,NH
90,2012,Jul,69.3,65.5,741133,699912,41221,5.6,NH
91,2012,Aug,69.4,65.5,742064,700728,41336,5.6,NH
92,2012,Sep,69.4,65.5,742994,701639,41355,5.6,NH
93,2012,Oct,69.4,65.6,743749,702413,41336,5.6,NH
94,2012,Nov,69.4,65.6,744167,702822,41345,5.6,NH
95,2012,Dec,69.4,65.6,744222,702860,41362,5.6,NH
96,2013,Jan,69.4,65.5,743915,702626,41289,5.6,NH
97,2013,Feb,69.3,65.5,743386,702355,41031,5.5,NH
98,2013,Mar,69.2,65.4,742974,702439,40535,5.5,NH
99,2013,Apr,69.2,65.5,743014,703126,39888,5.4,NH
100,2013,May,69.2,65.5,743406,704110,39296,5.3,NH
101,2013,Jun,69.2,65.6,743863,704956,38907,5.2,NH
102,2013,Jul,69.2,65.6,744128,705399,38729,5.2,NH
103,2013,Aug,69.1,65.6,743974,705430,38544,5.2,NH
104,2013,Sep,69.0,65.5,743413,705246,38167,5.1,NH
105,2013,Oct,68.9,65.4,742734,705115,37619,5.1,NH
106,2013,Nov,68.8,65.4,742214,705282,36932,5.0,NH
107,2013,Dec,68.7,65.4,741895,705727,36168,4.9,NH
108,2014,Jan,68.7,65.4,741760,706392,35368,4.8,NH
109,2014,Feb,68.7,65.5,741867,707296,34571,4.7,NH
110,2014,Mar,68.6,65.5,742090,708203,33887,4.6,NH
111,2014,Apr,68.6,65.5,742196,708849,33347,4.5,NH
112,2014,May,68.6,65.5,742270,709446,32824,4.4,NH
113,2014,Jun,68.6,65.6,742605,710355,32250,4.3,NH
114,2014,Jul,68.6,65.6,743222,711566,31656,4.3,NH
115,2014,Aug,68.6,65.7,744071,712953,31118,4.2,NH
116,2014,Sep,68.7,65.8,745108,714436,30672,4.1,NH
117,2014,Oct,68.7,65.9,746217,715986,30231,4.1,NH
118,2014,Nov,68.8,66.0,747167,717428,29739,4.0,NH
119,2014,Dec,68.8,66.1,747903,718654,29249,3.9,NH
120,2015,Jan,68.8,66.2,748374,719581,28793,3.8,NH
121,2015,Feb,68.8,66.2,748424,720050,28374,3.8,NH
122,2015,Mar,68.8,66.2,748091,720208,27883,3.7,NH
123,2015,Apr,68.7,66.2,747475,720243,27232,3.6,NH
124,2015,May,68.6,66.2,746588,720124,26464,3.5,NH
125,2015,Jun,68.5,66.1,745526,719859,25667,3.4,NH
126,2015,Jul,68.4,66.1,744639,719711,24928,3.3,NH
127,2015,Aug,68.3,66.0,744174,719896,24278,3.3,NH
128,2015,Sep,68.2,66.0,744217,720547,23670,3.2,NH
129,2015,Oct,68.2,66.1,744823,721725,23098,3.1,NH
130,2015,Nov,68.3,66.2,746012,723418,22594,3.0,NH
131,2015,Dec,68.4,66.4,747531,725396,22135,3.0,NH
132,2016,Jan,68.5,66.5,749043,727313,21730,2.9,NH
133,2016,Feb,68.6,66.6,750386,728939,21447,2.9,NH
134,2016,Mar,68.6,66.7,751461,730123,21338,2.8,NH
135,2016,Apr,68.7,66.7,752291,730870,21421,2.8,NH
136,2016,May,68.7,66.7,752948,731354,21594,2.9,NH
137,2016,Jun,68.7,66.7,753404,731703,21701,2.9,NH
138,2016,Jul,68.6,66.7,753667,731989,21678,2.9,NH
139,2016,Aug,68.6,66.6,753749,732167,21582,2.9,NH
140,2016,Sep,68.5,66.6,753622,732076,21546,2.9,NH
141,2016,Oct,68.4,66.5,753280,731676,21604,2.9,NH
142,2016,Nov,68.4,66.4,752930,731232,21698,2.9,NH
143,2016,Dec,68.3,66.3,752816,731026,21790,2.9,NH
144,2017,Jan,68.2,66.2,755955,734131,21824,2.9,NH
145,2017,Feb,68.2,66.3,756515,734822,21693,2.9,NH
146,2017,Mar,68.2,66.3,757171,735746,21425,2.8,NH
147,2017,Apr,68.2,66.3,757810,736689,21121,2.8,NH
148,2017,May,68.2,66.4,758365,737463,20902,2.8,NH
149,2017,Jun,68.2,66.3,758744,737883,20861,2.7,NH
150,2017,Jul,68.2,66.3,758881,737898,20983,2.8,NH
151,2017,Aug,68.1,66.2,758800,737635,21165,2.8,NH
152,2017,Sep,68.1,66.2,758648,737338,21310,2.8,NH
153,2017,Oct,68.0,66.1,758621,737283,21338,2.8,NH
154,2017,Nov,68.0,66.1,758833,737561,21272,2.8,NH
155,2017,Dec,68.0,66.1,759460,738354,21106,2.8,NH
156,2018,Jan,68.1,66.2,760685,739780,20905,2.7,NH
157,2018,Feb,68.2,66.4,762591,741831,20760,2.7,NH
158,2018,Mar,68.4,66.6,764942,744248,20694,2.7,NH
159,2018,Apr,68.6,66.7,767144,746517,20627,2.7,NH
160,2018,May,68.7,66.8,768618,748124,20494,2.7,NH
161,2018,Jun,68.7,66.9,769241,748953,20288,2.6,NH
162,2018,Jul,68.6,66.8,769191,749155,20036,2.6,NH
163,2018,Aug,68.5,66.8,768925,749086,19839,2.6,NH
164,2018,Sep,68.5,66.7,768834,749067,19767,2.6,NH
165,2018,Oct,68.5,66.7,769144,749328,19816,2.6,NH
166,2018,Nov,68.5,66.7,769853,749937,19916,2.6,NH
167,2018,Dec,68.5,66.7,770868,750880,19988,2.6,NH
168,2019,Jan,68.6,66.8,771972,751986,19986,2.6,NH
169,2019,Feb,68.6,66.9,772923,753063,19860,2.6,NH
170,2019,Mar,68.6,66.9,773661,753974,19687,2.5,NH
171,2019,Apr,68.7,66.9,774359,754789,19570,2.5,NH
172,2019,May,68.7,67.0,775193,755577,19616,2.5,NH
173,2019,Jun,68.7,67.0,776161,756305,19856,2.6,NH
174,2019,Jul,68.8,67.0,777182,756955,20227,2.6,NH
175,2019,Aug,68.8,67.0,778143,757548,20595,2.6,NH
176,2019,Sep,68.8,67.0,778995,758222,20773,2.7,NH
177,2019,Oct,68.8,67.0,779611,758791,20820,2.7,NH
178,2019,Nov,68.8,66.9,779724,758939,20785,2.7,NH
179,2019,Dec,68.6,66.8,778754,758038,20716,2.7,NH
180,2020,Jan,68.4,66.6,776467,755835,20632,2.7,NH
181,2020,Feb,68.1,66.3,773101,752576,20525,2.7,NH
182,2020,Mar,67.7,65.9,769324,748997,20327,2.6,NH
183,2020,Apr,65.4,54.8,743821,623305,120516,16.2,NH
184,2020,May,66.5,58.6,756340,666860,89480,11.8,NH
185,2020,Jun,66.3,59.9,754500,681473,73027,9.7,NH
186,2020,Jul,66.6,61.0,758119,694938,63181,8.3,NH
187,2020,Aug,66.3,61.9,756121,705060,51061,6.8,NH
188,2020,Sep,66.5,62.5,758886,712971,45915,6.1,NH
189,2020,Oct,66.3,62.8,757130,717628,39502,5.2,NH
190,2020,Nov,66.2,63.0,756730,720314,36416,4.8,NH
191,2020,Dec,66.1,63.1,756086,721820,34266,4.5,NH
192,2021,Jan,65.9,63.2,754864,723083,31781,4.2,NH
193,2021,Feb,65.9,63.2,754905,724523,30382,4.0,NH
194,2021,Mar,65.9,63.3,755492,726226,29266,3.9,NH
195,2021,Apr,65.9,63.4,756492,727826,28666,3.8,NH
196,2021,May,65.9,63.4,756674,728935,27739,3.7,NH
197,2021,Jun,65.8,63.4,756557,729254,27303,3.6,NH
198,2021,Jul,65.6,63.3,755645,729282,26363,3.5,NH
199,2021,Aug,65.5,63.3,754807,729423,25384,3.4,NH
200,2021,Sep,65.3,63.2,754305,730051,24254,3.2,NH
201,2021,Oct,65.3,63.2,754359,731034,23325,3.1,NH
202,2021,Nov,65.2,63.2,754631,731855,22776,3.0,NH
203,2021,Dec,65.2,63.2,754856,732338,22518,3.0,NH
204,2022,Jan,65.2,63.3,755532,733378,22154,2.9,NH
205,2022,Feb,65.2,63.4,756659,736187,20472,2.7,NH
206,2022,Mar,65.3,63.7,758614,740028,18586,2.4,NH
207,2022,Apr,65.3,63.8,759932,742436,17496,2.3,NH
208,2022,May,65.5,64.1,762367,746090,16277,2.1,NH
209,2022,Jun,65.6,64.3,764631,749090,15541,2.0,NH
210,2022,Jul,65.7,64.4,766697,751695,15002,2.0,NH
211,2022,Aug,65.8,64.5,769176,753634,15542,2.0,NH
212,2022,Sep,65.9,64.5,770755,754154,16601,2.2,NH
213,2022,Oct,65.9,64.3,771940,753604,18336,2.4,NH
214,2022,Nov,65.8,64.2,772198,752491,19707,2.6,NH
0,2005,Jan,55.1,52.0,789441,744992,44449,5.6,WV
1,2005,Feb,55.1,52.0,789982,745710,44272,5.6,WV
2,2005,Mar,55.2,52.1,790732,746873,43859,5.5,WV
3,2005,Apr,55.2,52.2,791798,748412,43386,5.5,WV
4,2005,May,55.3,52.3,793127,750104,43023,5.4,WV
5,2005,Jun,55.4,52.4,794490,751601,42889,5.4,WV
6,2005,Jul,55.5,52.5,795733,752689,43044,5.4,WV
7,2005,Aug,55.5,52.5,796724,753416,43308,5.4,WV
8,2005,Sep,55.5,52.5,797404,753972,43432,5.4,WV
9,2005,Oct,55.5,52.5,797841,754692,43149,5.4,WV
10,2005,Nov,55.5,52.6,798171,755752,42419,5.3,WV
11,2005,Dec,55.5,52.7,798687,757175,41512,5.2,WV
12,2006,Jan,55.6,52.8,799606,758886,40720,5.1,WV
13,2006,Feb,55.7,52.9,800803,760564,40239,5.0,WV
14,2006,Mar,55.8,53.0,802072,761818,40254,5.0,WV
15,2006,Apr,55.8,53.0,803284,762471,40813,5.1,WV
16,2006,May,55.9,53.0,804340,762671,41669,5.2,WV
17,2006,Jun,55.9,53.0,805217,762682,42535,5.3,WV
18,2006,Jul,56.0,53.0,806015,762889,43126,5.4,WV
19,2006,Aug,56.0,53.0,806777,763493,43284,5.4,WV
20,2006,Sep,56.0,53.0,807404,764376,43028,5.3,WV
21,2006,Oct,56.0,53.1,807734,765299,42435,5.3,WV
22,2006,Nov,56.0,53.1,807634,765992,41642,5.2,WV
23,2006,Dec,55.9,53.1,806919,766149,40770,5.1,WV
24,2007,Jan,55.8,53.1,805561,765642,39919,5.0,WV
25,2007,Feb,55.7,53.0,803965,764782,39183,4.9,WV
26,2007,Mar,55.6,52.9,802527,763964,38563,4.8,WV
27,2007,Apr,55.5,52.9,801602,763516,38086,4.8,WV
28,2007,May,55.5,52.9,801447,763577,37870,4.7,WV
29,2007,Jun,55.5,52.9,802046,764133,37913,4.7,WV
30,2007,Jul,55.6,53.0,803177,764977,38200,4.8,WV
31,2007,Aug,55.7,53.0,804627,765916,38711,4.8,WV
32,2007,Sep,55.8,53.1,806067,766894,39173,4.9,WV
33,2007,Oct,55.8,53.1,807066,767739,39327,4.9,WV
34,2007,Nov,55.8,53.1,807417,768357,39060,4.8,WV
35,2007,Dec,55.8,53.1,807291,768882,38409,4.8,WV
36,2008,Jan,55.8,53.2,806965,769341,37624,4.7,WV
37,2008,Feb,55.7,53.2,806592,769703,36889,4.6,WV
38,2008,Mar,55.7,53.2,806233,769968,36265,4.5,WV
39,2008,Apr,55.7,53.2,805897,770072,35825,4.4,WV
40,2008,May,55.6,53.2,805631,770016,35615,4.4,WV
41,2008,Jun,55.6,53.2,805535,769877,35658,4.4,WV
42,2008,Jul,55.6,53.1,805550,769626,35924,4.5,WV
43,2008,Aug,55.6,53.1,805648,769123,36525,4.5,WV
44,2008,Sep,55.6,53.0,805969,768154,37815,4.7,WV
45,2008,Oct,55.6,52.9,806636,766594,40042,5.0,WV
46,2008,Nov,55.7,52.7,807678,764387,43291,5.4,WV
47,2008,Dec,55.8,52.5,808940,761482,47458,5.9,WV
48,2009,Jan,55.8,52.2,810279,758012,52267,6.5,WV
49,2009,Feb,55.9,52.0,811767,754397,57370,7.1,WV
50,2009,Mar,56.0,51.7,813446,751178,62268,7.7,WV
51,2009,Apr,56.1,51.6,815011,748641,66370,8.1,WV
52,2009,May,56.2,51.4,815875,746552,69323,8.5,WV
53,2009,Jun,56.1,51.3,815673,744591,71082,8.7,WV
54,2009,Jul,56.0,51.1,814325,742532,71793,8.8,WV
55,2009,Aug,55.9,50.9,812047,740294,71753,8.8,WV
56,2009,Sep,55.7,50.7,809466,738033,71433,8.8,WV
57,2009,Oct,55.5,50.6,807341,736007,71334,8.8,WV
58,2009,Nov,55.4,50.5,806250,734638,71612,8.9,WV
59,2009,Dec,55.4,50.4,806459,734370,72089,8.9,WV
60,2010,Jan,55.5,50.5,807671,735302,72369,9.0,WV
61,2010,Feb,55.6,50.6,809095,736973,72122,8.9,WV
62,2010,Mar,55.6,50.7,810179,738804,71375,8.8,WV
63,2010,Apr,54.7,50.0,810822,740453,70369,8.7,WV
64,2010,May,54.7,50.1,811064,741736,69328,8.5,WV
65,2010,Jun,54.7,50.1,810955,742393,68562,8.5,WV
66,2010,Jul,54.7,50.1,810702,742317,68385,8.4,WV
67,2010,Aug,54.6,50.0,810504,741710,68794,8.5,WV
68,2010,Sep,54.6,49.9,810266,740860,69406,8.6,WV
69,2010,Oct,54.6,49.9,809927,740140,69787,8.6,WV
70,2010,Nov,54.5,49.8,809442,739736,69706,8.6,WV
71,2010,Dec,54.5,49.8,808714,739615,69099,8.5,WV
72,2011,Jan,54.4,49.8,807822,739734,68088,8.4,WV
73,2011,Feb,54.3,49.8,806776,739946,66830,8.3,WV
74,2011,Mar,54.2,49.8,805513,740073,65440,8.1,WV
75,2011,Apr,54.1,49.8,804257,740071,64186,8.0,WV
76,2011,May,54.1,49.8,803485,740139,63346,7.9,WV
77,2011,Jun,54.1,49.8,803534,740625,62909,7.8,WV
78,2011,Jul,54.1,49.9,804493,741792,62701,7.8,WV
79,2011,Aug,54.2,50.0,806051,743580,62471,7.8,WV
80,2011,Sep,54.3,50.1,807653,745687,61966,7.7,WV
81,2011,Oct,54.4,50.3,808794,747742,61052,7.5,WV
82,2011,Nov,54.4,50.4,809104,749353,59751,7.4,WV
83,2011,Dec,54.4,50.4,808721,750368,58353,7.2,WV
84,2012,Jan,54.3,50.5,808113,750875,57238,7.1,WV
85,2012,Feb,54.3,50.5,807794,751038,56756,7.0,WV
86,2012,Mar,54.3,50.5,807907,750858,57049,7.1,WV
87,2012,Apr,54.3,50.4,808217,750339,57878,7.2,WV
88,2012,May,54.3,50.4,808594,749734,58860,7.3,WV
89,2012,Jun,54.4,50.4,808884,749257,59627,7.4,WV
90,2012,Jul,54.4,50.3,808914,748988,59926,7.4,WV
91,2012,Aug,54.3,50.3,808788,748953,59835,7.4,WV
92,2012,Sep,54.3,50.3,808686,749108,59578,7.4,WV
93,2012,Oct,54.3,50.3,808416,749232,59184,7.3,WV
94,2012,Nov,54.3,50.3,807801,749142,58659,7.3,WV
95,2012,Dec,54.2,50.3,806607,748703,57904,7.2,WV
96,2013,Jan,54.1,50.3,804803,747905,56898,7.1,WV
97,2013,Feb,54.0,50.2,802827,747084,55743,6.9,WV
98,2013,Mar,53.9,50.2,801204,746643,54561,6.8,WV
99,2013,Apr,53.8,50.2,800277,746757,53520,6.7,WV
100,2013,May,53.8,50.2,799870,747059,52811,6.6,WV
101,2013,Jun,53.8,50.2,799704,747163,52541,6.6,WV
102,2013,Jul,53.8,50.2,799498,746886,52612,6.6,WV
103,2013,Aug,53.7,50.2,798902,746160,52742,6.6,WV
104,2013,Sep,53.7,50.1,797953,745123,52830,6.6,WV
105,2013,Oct,53.6,50.0,797136,744107,53029,6.7,WV
106,2013,Nov,53.6,50.0,796772,743443,53329,6.7,WV
107,2013,Dec,53.6,50.0,796988,743337,53651,6.7,WV
108,2014,Jan,53.7,50.0,797557,743740,53817,6.7,WV
109,2014,Feb,53.7,50.1,797946,744294,53652,6.7,WV
110,2014,Mar,53.7,50.1,797830,744590,53240,6.7,WV
111,2014,Apr,53.7,50.1,797081,744377,52704,6.6,WV
112,2014,May,53.6,50.1,795967,743871,52096,6.5,WV
113,2014,Jun,53.5,50.1,794976,743439,51537,6.5,WV
114,2014,Jul,53.5,50.1,794363,743221,51142,6.4,WV
115,2014,Aug,53.5,50.1,794272,743335,50937,6.4,WV
116,2014,Sep,53.5,50.1,794534,743734,50800,6.4,WV
117,2014,Oct,53.5,50.1,794725,744126,50599,6.4,WV
118,2014,Nov,53.5,50.1,794615,744200,50415,6.3,WV
119,2014,Dec,53.5,50.1,794247,743765,50482,6.4,WV
120,2015,Jan,53.5,50.1,793820,742884,50936,6.4,WV
121,2015,Feb,53.5,50.0,793628,741810,51818,6.5,WV
122,2015,Mar,53.6,50.0,793761,740877,52884,6.7,WV
123,2015,Apr,53.6,50.0,794032,740233,53799,6.8,WV
124,2015,May,53.6,50.0,793992,739757,54235,6.8,WV
125,2015,Jun,53.6,49.9,793269,739251,54018,6.8,WV
126,2015,Jul,53.5,49.9,791959,738717,53242,6.7,WV
127,2015,Aug,53.4,49.9,790409,738212,52197,6.6,WV
128,2015,Sep,53.3,49.9,789048,737859,51189,6.5,WV
129,2015,Oct,53.3,49.9,788329,737853,50476,6.4,WV
130,2015,Nov,53.3,49.9,788344,738192,50152,6.4,WV
131,2015,Dec,53.4,50.0,788821,738713,50108,6.4,WV
132,2016,Jan,53.4,50.0,789352,739186,50166,6.4,WV
133,2016,Feb,53.5,50.1,789436,739332,50104,6.3,WV
134,2016,Mar,53.4,50.1,788767,739023,49744,6.3,WV
135,2016,Apr,53.4,50.0,787459,738270,49189,6.2,WV
136,2016,May,53.3,50.0,785938,737255,48683,6.2,WV
137,2016,Jun,53.2,49.9,784596,736276,48320,6.2,WV
138,2016,Jul,53.2,49.9,783598,735591,48007,6.1,WV
139,2016,Aug,53.1,49.9,782962,735299,47663,6.1,WV
140,2016,Sep,53.1,49.9,782586,735395,47191,6.0,WV
141,2016,Oct,53.1,50.0,782275,735838,46437,5.9,WV
142,2016,Nov,53.2,50.1,782016,736667,45349,5.8,WV
143,2016,Dec,53.2,50.2,781718,737762,43956,5.6,WV
144,2017,Jan,53.2,50.3,782265,739919,42346,5.4,WV
145,2017,Feb,53.2,50.4,781856,740956,40900,5.2,WV
146,2017,Mar,53.2,50.5,781658,741764,39894,5.1,WV
147,2017,Apr,53.2,50.5,781942,742508,39434,5.0,WV
148,2017,May,53.3,50.6,782759,743381,39378,5.0,WV
149,2017,Jun,53.4,50.7,783929,744274,39655,5.1,WV
150,2017,Jul,53.5,50.8,785269,745020,40249,5.1,WV
151,2017,Aug,53.6,50.9,786433,745515,40918,5.2,WV
152,2017,Sep,53.7,50.9,787155,745669,41486,5.3,WV
153,2017,Oct,53.7,50.9,787430,745509,41921,5.3,WV
154,2017,Nov,53.8,50.9,787406,745139,42267,5.4,WV
155,2017,Dec,53.8,50.9,787528,745022,42506,5.4,WV
156,2018,Jan,53.9,51.0,788267,745615,42652,5.4,WV
157,2018,Feb,54.0,51.1,789813,747120,42693,5.4,WV
158,2018,Mar,54.2,51.3,791877,749326,42551,5.4,WV
159,2018,Apr,54.4,51.5,793742,751592,42150,5.3,WV
160,2018,May,54.5,51.6,794963,753339,41624,5.2,WV
161,2018,Jun,54.5,51.7,795470,754445,41025,5.2,WV
162,2018,Jul,54.5,51.8,795345,754974,40371,5.1,WV
163,2018,Aug,54.5,51.8,795020,755112,39908,5.0,WV
164,2018,Sep,54.5,51.8,794831,754999,39832,5.0,WV
165,2018,Oct,54.5,51.8,794849,754796,40053,5.0,WV
166,2018,Nov,54.6,51.8,794974,754665,40309,5.1,WV
167,2018,Dec,54.6,51.8,794937,754637,40300,5.1,WV
168,2019,Jan,54.6,51.8,794578,754656,39922,5.0,WV
169,2019,Feb,54.6,51.9,793999,754796,39203,4.9,WV
170,2019,Mar,54.6,51.9,793594,755161,38433,4.8,WV
171,2019,Apr,54.6,52.0,793774,755905,37869,4.8,WV
172,2019,May,54.7,52.1,794581,756916,37665,4.7,WV
173,2019,Jun,54.8,52.2,795842,757894,37948,4.8,WV
174,2019,Jul,54.9,52.2,797220,758546,38674,4.9,WV
175,2019,Aug,55.0,52.3,798390,758875,39515,4.9,WV
176,2019,Sep,55.1,52.3,799324,759319,40005,5.0,WV
177,2019,Oct,55.1,52.3,800126,759948,40178,5.0,WV
178,2019,Nov,55.2,52.4,800704,760481,40223,5.0,WV
179,2019,Dec,55.2,52.4,800856,760426,40430,5.0,WV
180,2020,Jan,55.2,52.4,800329,759576,40753,5.1,WV
181,2020,Feb,55.1,52.3,798843,757812,41031,5.1,WV
182,2020,Mar,55.0,52.1,796512,755401,41111,5.2,WV
183,2020,Apr,52.7,44.6,763890,645656,118234,15.5,WV
184,2020,May,53.7,47.2,777537,682891,94646,12.2,WV
185,2020,Jun,53.6,48.0,775839,694902,80937,10.4,WV
186,2020,Jul,53.9,48.8,779583,705988,73595,9.4,WV
187,2020,Aug,53.9,49.4,779091,714592,64499,8.3,WV
188,2020,Sep,54.0,49.9,780708,721428,59280,7.6,WV
189,2020,Oct,54.0,50.2,779782,725993,53789,6.9,WV
190,2020,Nov,54.0,50.5,780099,729465,50634,6.5,WV
191,2020,Dec,54.1,50.7,781028,732293,48735,6.2,WV
192,2021,Jan,54.1,50.9,781354,734917,46437,5.9,WV
193,2021,Feb,54.2,51.1,782743,737651,45092,5.8,WV
194,2021,Mar,54.4,51.3,784953,740671,44282,5.6,WV
195,2021,Apr,54.6,51.6,787203,743634,43569,5.5,WV
196,2021,May,54.7,51.7,788988,746278,42710,5.4,WV
197,2021,Jun,54.8,51.9,790180,748330,41850,5.3,WV
198,2021,Jul,54.8,52.0,790571,750396,40175,5.1,WV
199,2021,Aug,54.8,52.2,790819,752644,38175,4.8,WV
200,2021,Sep,54.8,52.3,791190,755175,36015,4.6,WV
201,2021,Oct,54.9,52.5,791877,757445,34432,4.3,WV
202,2021,Nov,54.9,52.5,792211,758285,33926,4.3,WV
203,2021,Dec,54.9,52.5,792320,758449,33871,4.3,WV
204,2022,Jan,55.0,52.7,793335,761138,32197,4.1,WV
205,2022,Feb,55.0,52.9,793816,763032,30784,3.9,WV
206,2022,Mar,55.0,53.0,794227,765159,29068,3.7,WV
207,2022,Apr,55.1,53.1,794631,766204,28427,3.6,WV
208,2022,May,55.1,53.2,795824,767918,27906,3.5,WV
209,2022,Jun,55.2,53.2,796968,768311,28657,3.6,WV
210,2022,Jul,55.2,53.2,797404,767823,29581,3.7,WV
211,2022,Aug,55.2,53.0,796918,765939,30979,3.9,WV
212,2022,Sep,55.1,52.9,795828,764315,31513,4.0,WV
213,2022,Oct,55.0,52.8,794480,762325,32155,4.0,WV
214,2022,Nov,54.9,52.7,793427,760775,32652,4.1,WV
0,2005,Jan,66.5,63.2,1775159,1687677,87482,4.9,CT
1,2005,Feb,66.6,63.3,1778212,1690532,87680,4.9,CT
2,2005,Mar,66.7,63.4,1781743,1694123,87620,4.9,CT
3,2005,Apr,66.8,63.5,1785633,1698358,87275,4.9,CT
4,2005,May,66.9,63.7,1789854,1703125,86729,4.8,CT
5,2005,Jun,67.1,63.8,1793985,1707802,86183,4.8,CT
6,2005,Jul,67.2,64.0,1797541,1711644,85897,4.8,CT
7,2005,Aug,67.2,64.0,1800444,1714626,85818,4.8,CT
8,2005,Sep,67.3,64.1,1803280,1717539,85741,4.8,CT
9,2005,Oct,67.3,64.1,1806325,1720905,85420,4.7,CT
10,2005,Nov,67.4,64.2,1809526,1724701,84825,4.7,CT
11,2005,Dec,67.5,64.3,1812780,1728795,83985,4.6,CT
12,2006,Jan,67.6,64.5,1816063,1733100,82963,4.6,CT
13,2006,Feb,67.6,64.6,1819226,1737275,81951,4.5,CT
14,2006,Mar,67.7,64.7,1822224,1741020,81204,4.5,CT
15,2006,Apr,67.8,64.8,1824847,1743960,80887,4.4,CT
16,2006,May,67.9,64.9,1826938,1746106,80832,4.4,CT
17,2006,Jun,67.9,64.9,1828775,1747945,80830,4.4,CT
18,2006,Jul,68.0,65.0,1830942,1750241,80701,4.4,CT
19,2006,Aug,68.0,65.0,1833746,1753195,80551,4.4,CT
20,2006,Sep,68.1,65.1,1836913,1756417,80496,4.4,CT
21,2006,Oct,68.2,65.2,1840211,1759811,80400,4.4,CT
22,2006,Nov,68.3,65.3,1843373,1763165,80208,4.4,CT
23,2006,Dec,68.4,65.4,1845968,1766016,79952,4.3,CT
24,2007,Jan,68.4,65.5,1848030,1768257,79773,4.3,CT
25,2007,Feb,68.4,65.5,1849724,1769948,79776,4.3,CT
26,2007,Mar,68.5,65.5,1850803,1770914,79889,4.3,CT
27,2007,Apr,68.5,65.5,1851481,1771391,80090,4.3,CT
28,2007,May,68.5,65.5,1852382,1771872,80510,4.3,CT
29,2007,Jun,68.5,65.5,1853582,1772394,81188,4.4,CT
30,2007,Jul,68.5,65.5,1855062,1772917,82145,4.4,CT
31,2007,Aug,68.6,65.5,1857126,1773734,83392,4.5,CT
32,2007,Sep,68.6,65.5,1859938,1775209,84729,4.6,CT
33,2007,Oct,68.7,65.5,1862997,1776872,86125,4.6,CT
34,2007,Nov,68.7,65.5,1865712,1778299,87413,4.7,CT
35,2007,Dec,68.8,65.5,1867928,1779384,88544,4.7,CT
36,2008,Jan,68.8,65.5,1869605,1779846,89759,4.8,CT
37,2008,Feb,68.8,65.4,1871046,1779792,91254,4.9,CT
38,2008,Mar,68.8,65.4,1872549,1779225,93324,5.0,CT
39,2008,Apr,68.8,65.3,1874146,1778038,96108,5.1,CT
40,2008,May,68.9,65.2,1875861,1776383,99478,5.3,CT
41,2008,Jun,68.9,65.1,1877881,1774721,103160,5.5,CT
42,2008,Jul,68.9,65.0,1879919,1773119,106800,5.7,CT
43,2008,Aug,68.9,64.9,1881524,1771270,110254,5.9,CT
44,2008,Sep,68.9,64.8,1882648,1768820,113828,6.0,CT
45,2008,Oct,68.9,64.6,1883668,1765753,117915,6.3,CT
46,2008,Nov,68.9,64.4,1884613,1761893,122720,6.5,CT
47,2008,Dec,68.9,64.2,1885195,1757045,128150,6.8,CT
48,2009,Jan,68.8,64.0,1885168,1751324,133844,7.1,CT
49,2009,Feb,68.8,63.7,1885022,1745553,139469,7.4,CT
50,2009,Mar,68.8,63.5,1885758,1741164,144594,7.7,CT
51,2009,Apr,68.8,63.4,1887457,1738492,148965,7.9,CT
52,2009,May,68.9,63.3,1889319,1736551,152768,8.1,CT
53,2009,Jun,68.9,63.2,1890959,1734700,156259,8.3,CT
54,2009,Jul,68.9,63.1,1891930,1732321,159609,8.4,CT
55,2009,Aug,68.8,62.9,1891764,1728836,162928,8.6,CT
56,2009,Sep,68.7,62.7,1890575,1724297,166278,8.8,CT
57,2009,Oct,68.6,62.4,1888815,1719152,169663,9.0,CT
58,2009,Nov,68.5,62.2,1887858,1714686,173172,9.2,CT
59,2009,Dec,68.5,62.1,1889075,1712315,176760,9.4,CT
60,2010,Jan,68.6,62.1,1892594,1712632,179962,9.5,CT
61,2010,Feb,68.8,62.2,1897276,1714982,182294,9.6,CT
62,2010,Mar,68.9,62.3,1902002,1718400,183602,9.7,CT
63,2010,Apr,68.0,61.5,1906595,1722636,183959,9.6,CT
64,2010,May,68.1,61.6,1910818,1727354,183464,9.6,CT
65,2010,Jun,68.2,61.7,1914097,1731412,182685,9.5,CT
66,2010,Jul,68.2,61.7,1916460,1734133,182327,9.5,CT
67,2010,Aug,68.2,61.7,1918237,1735650,182587,9.5,CT
68,2010,Sep,68.2,61.7,1919267,1736057,183210,9.5,CT
69,2010,Oct,68.2,61.6,1919649,1735952,183697,9.6,CT
70,2010,Nov,68.1,61.6,1919392,1735829,183563,9.6,CT
71,2010,Dec,68.0,61.6,1918366,1735774,182592,9.5,CT
72,2011,Jan,68.0,61.5,1917092,1736022,181070,9.4,CT
73,2011,Feb,67.9,61.5,1915799,1736443,179356,9.4,CT
74,2011,Mar,67.8,61.5,1914283,1736677,177606,9.3,CT
75,2011,Apr,67.7,61.5,1912529,1736438,176091,9.2,CT
76,2011,May,67.6,61.4,1911140,1736109,175031,9.2,CT
77,2011,Jun,67.6,61.4,1910692,1736564,174128,9.1,CT
78,2011,Jul,67.5,61.4,1911543,1738579,172964,9.0,CT
79,2011,Aug,67.6,61.5,1913385,1742023,171362,9.0,CT
80,2011,Sep,67.6,61.6,1915535,1746278,169257,8.8,CT
81,2011,Oct,67.6,61.7,1917084,1750252,166832,8.7,CT
82,2011,Nov,67.6,61.8,1917061,1752728,164333,8.6,CT
83,2011,Dec,67.5,61.8,1915340,1753314,162026,8.5,CT
84,2012,Jan,67.4,61.7,1912351,1752189,160162,8.4,CT
85,2012,Feb,67.2,61.6,1908624,1749642,158982,8.3,CT
86,2012,Mar,67.0,61.4,1904314,1745620,158694,8.3,CT
87,2012,Apr,66.8,61.2,1899200,1740242,158958,8.4,CT
88,2012,May,66.6,61.0,1893644,1734363,159281,8.4,CT
89,2012,Jun,66.4,60.8,1887999,1728720,159279,8.4,CT
90,2012,Jul,66.1,60.6,1882615,1723907,158708,8.4,CT
91,2012,Aug,66.0,60.4,1878205,1720408,157797,8.4,CT
92,2012,Sep,65.8,60.3,1875209,1718236,156973,8.4,CT
93,2012,Oct,65.7,60.2,1873204,1716902,156302,8.3,CT
94,2012,Nov,65.6,60.2,1871522,1715773,155749,8.3,CT
95,2012,Dec,65.6,60.1,1869431,1714212,155219,8.3,CT
96,2013,Jan,65.4,60.0,1866718,1712022,154696,8.3,CT
97,2013,Feb,65.3,59.9,1864254,1710153,154101,8.3,CT
98,2013,Mar,65.3,59.9,1863120,1709824,153296,8.2,CT
99,2013,Apr,65.3,60.0,1863931,1711614,152317,8.2,CT
100,2013,May,65.4,60.1,1866153,1714775,151378,8.1,CT
101,2013,Jun,65.4,60.2,1868813,1718256,150557,8.1,CT
102,2013,Jul,65.5,60.2,1870801,1721124,149677,8.0,CT
103,2013,Aug,65.5,60.3,1871349,1723188,148161,7.9,CT
104,2013,Sep,65.4,60.3,1870764,1724994,145770,7.8,CT
105,2013,Oct,65.4,60.4,1870128,1727081,143047,7.6,CT
106,2013,Nov,65.4,60.5,1870266,1729880,140386,7.5,CT
107,2013,Dec,65.4,60.6,1871503,1733625,137878,7.4,CT
108,2014,Jan,65.4,60.7,1873722,1738339,135383,7.2,CT
109,2014,Feb,65.5,60.9,1876435,1743577,132858,7.1,CT
110,2014,Mar,65.6,61.0,1879255,1748668,130587,6.9,CT
111,2014,Apr,65.7,61.2,1882025,1753324,128701,6.8,CT
112,2014,May,65.8,61.3,1884757,1757743,127014,6.7,CT
113,2014,Jun,65.8,61.5,1887936,1762463,125473,6.6,CT
114,2014,Jul,65.9,61.6,1891461,1767363,124098,6.6,CT
115,2014,Aug,66.0,61.8,1894819,1771979,122840,6.5,CT
116,2014,Sep,66.1,61.9,1897546,1776030,121516,6.4,CT
117,2014,Oct,66.2,62.0,1899432,1779699,119733,6.3,CT
118,2014,Nov,66.2,62.1,1900520,1783052,117468,6.2,CT
119,2014,Dec,66.2,62.2,1901233,1786010,115223,6.1,CT
120,2015,Jan,66.2,62.3,1901701,1788370,113331,6.0,CT
121,2015,Feb,66.2,62.3,1901730,1789810,111920,5.9,CT
122,2015,Mar,66.2,62.4,1900978,1790269,110709,5.8,CT
123,2015,Apr,66.1,62.3,1899181,1789732,109449,5.8,CT
124,2015,May,66.0,62.3,1896379,1788339,108040,5.7,CT
125,2015,Jun,65.9,62.2,1892772,1786301,106471,5.6,CT
126,2015,Jul,65.8,62.1,1889106,1784137,104969,5.6,CT
127,2015,Aug,65.7,62.0,1886215,1782474,103741,5.5,CT
128,2015,Sep,65.6,62.0,1884305,1781625,102680,5.4,CT
129,2015,Oct,65.5,62.0,1883557,1781801,101756,5.4,CT
130,2015,Nov,65.6,62.0,1883966,1782985,100981,5.4,CT
131,2015,Dec,65.6,62.1,1884911,1784830,100081,5.3,CT
132,2016,Jan,65.6,62.2,1885910,1787016,98894,5.2,CT
133,2016,Feb,65.7,62.3,1886939,1789442,97497,5.2,CT
134,2016,Mar,65.7,62.4,1888081,1792129,95952,5.1,CT
135,2016,Apr,65.7,62.5,1889305,1794839,94466,5.0,CT
136,2016,May,65.8,62.5,1890682,1797493,93189,4.9,CT
137,2016,Jun,65.8,62.6,1892133,1800092,92041,4.9,CT
138,2016,Jul,65.9,62.7,1893536,1802669,90867,4.8,CT
139,2016,Aug,65.9,62.8,1894991,1805214,89777,4.7,CT
140,2016,Sep,66.0,62.9,1896690,1807641,89049,4.7,CT
141,2016,Oct,66.0,62.9,1898583,1810005,88578,4.7,CT
142,2016,Nov,66.1,63.0,1900809,1812673,88136,4.6,CT
143,2016,Dec,66.2,63.1,1903587,1815897,87690,4.6,CT
144,2017,Jan,66.4,63.4,1924150,1836282,87868,4.6,CT
145,2017,Feb,66.5,63.5,1927400,1840062,87338,4.5,CT
146,2017,Mar,66.6,63.6,1929652,1842864,86788,4.5,CT
147,2017,Apr,66.6,63.6,1930564,1844343,86221,4.5,CT
148,2017,May,66.6,63.6,1930068,1844470,85598,4.4,CT
149,2017,Jun,66.5,63.6,1928233,1843190,85043,4.4,CT
150,2017,Jul,66.4,63.5,1925520,1840878,84642,4.4,CT
151,2017,Aug,66.2,63.3,1922196,1837969,84227,4.4,CT
152,2017,Sep,66.1,63.2,1918762,1835036,83726,4.4,CT
153,2017,Oct,66.0,63.1,1915879,1832749,83130,4.3,CT
154,2017,Nov,65.9,63.0,1913860,1831392,82468,4.3,CT
155,2017,Dec,65.8,63.0,1913150,1831551,81599,4.3,CT
156,2018,Jan,65.9,63.1,1914126,1833522,80604,4.2,CT
157,2018,Feb,65.9,63.2,1917006,1837410,79596,4.2,CT
158,2018,Mar,66.1,63.4,1921347,1842774,78573,4.1,CT
159,2018,Apr,66.2,63.6,1926073,1848578,77495,4.0,CT
160,2018,May,66.4,63.7,1930061,1853593,76468,4.0,CT
161,2018,Jun,66.4,63.8,1932975,1857475,75500,3.9,CT
162,2018,Jul,66.5,63.9,1934953,1860403,74550,3.9,CT
163,2018,Aug,66.5,64.0,1936517,1862712,73805,3.8,CT
164,2018,Sep,66.6,64.0,1937971,1864603,73368,3.8,CT
165,2018,Oct,66.6,64.1,1939340,1866228,73112,3.8,CT
166,2018,Nov,66.6,64.1,1940661,1867834,72827,3.8,CT
167,2018,Dec,66.7,64.2,1941904,1869577,72327,3.7,CT
168,2019,Jan,66.7,64.3,1942918,1871367,71551,3.7,CT
169,2019,Feb,66.7,64.3,1943590,1873144,70446,3.6,CT
170,2019,Mar,66.8,64.4,1944162,1874877,69285,3.6,CT
171,2019,Apr,66.8,64.5,1945128,1876820,68308,3.5,CT
172,2019,May,66.9,64.5,1946722,1879011,67711,3.5,CT
173,2019,Jun,66.9,64.6,1948897,1881282,67615,3.5,CT
174,2019,Jul,67.0,64.7,1951186,1883233,67953,3.5,CT
175,2019,Aug,67.0,64.7,1953344,1884967,68377,3.5,CT
176,2019,Sep,67.1,64.8,1955509,1887112,68397,3.5,CT
177,2019,Oct,67.2,64.8,1957603,1889362,68241,3.5,CT
178,2019,Nov,67.2,64.9,1959190,1891108,68082,3.5,CT
179,2019,Dec,67.2,64.8,1958825,1890967,67858,3.5,CT
180,2020,Jan,67.1,64.8,1955906,1888465,67441,3.4,CT
181,2020,Feb,66.9,64.6,1950771,1883931,66840,3.4,CT
182,2020,Mar,66.7,64.4,1944775,1878877,65898,3.4,CT
183,2020,Apr,63.1,58.1,1840803,1694407,146396,8.0,CT
184,2020,May,65.7,58.2,1915301,1696323,218978,11.4,CT
185,2020,Jun,65.5,58.2,1908325,1696962,211363,11.1,CT
186,2020,Jul,65.8,58.4,1916680,1702587,214093,11.2,CT
187,2020,Aug,64.6,58.5,1884280,1705729,178551,9.5,CT
188,2020,Sep,64.4,58.7,1878425,1710459,167966,8.9,CT
189,2020,Oct,63.8,58.6,1861060,1710946,150114,8.1,CT
190,2020,Nov,63.6,58.6,1856081,1711450,144631,7.8,CT
191,2020,Dec,63.5,58.6,1853792,1711536,142256,7.7,CT
192,2021,Jan,63.3,58.6,1847172,1712261,134911,7.3,CT
193,2021,Feb,63.2,58.7,1846719,1714601,132118,7.2,CT
194,2021,Mar,63.3,58.8,1847871,1718902,128969,7.0,CT
195,2021,Apr,63.5,59.0,1853765,1724237,129528,7.0,CT
196,2021,May,63.4,59.2,1853898,1730239,123659,6.7,CT
197,2021,Jun,63.7,59.4,1861467,1736426,125041,6.7,CT
198,2021,Jul,63.6,59.5,1859930,1742212,117718,6.3,CT
199,2021,Aug,63.6,59.7,1861388,1748664,112724,6.1,CT
200,2021,Sep,63.5,59.9,1859051,1754406,104645,5.6,CT
201,2021,Oct,63.5,60.0,1860534,1759603,100931,5.4,CT
202,2021,Nov,63.3,60.0,1856259,1759666,96593,5.2,CT
203,2021,Dec,63.2,59.9,1853732,1759082,94650,5.1,CT
204,2022,Jan,63.6,60.2,1867297,1768477,98820,5.3,CT
205,2022,Feb,63.6,60.5,1869116,1778020,91096,4.9,CT
206,2022,Mar,64.0,61.0,1879286,1793229,86057,4.6,CT
207,2022,Apr,64.2,61.4,1887900,1804200,83700,4.4,CT
208,2022,May,64.4,61.8,1895079,1816424,78655,4.2,CT
209,2022,Jun,64.6,62.0,1901301,1825333,75968,4.0,CT
210,2022,Jul,64.5,62.1,1899981,1828804,71177,3.7,CT
211,2022,Aug,64.7,62.0,1905529,1827827,77702,4.1,CT
212,2022,Sep,64.6,62.0,1903495,1826631,76864,4.0,CT
213,2022,Oct,64.5,61.8,1903650,1822390,81260,4.3,CT
214,2022,Nov,64.3,61.6,1898668,1819032,79636,4.2,CT
0,2005,Jan,66.6,62.6,6380668,5998455,382213,6.0,IL
1,2005,Feb,66.6,62.6,6385992,6004806,381186,6.0,IL
2,2005,Mar,66.6,62.7,6391368,6011404,379964,5.9,IL
3,2005,Apr,66.7,62.7,6397182,6019020,378162,5.9,IL
4,2005,May,66.7,62.8,6403350,6028017,375333,5.9,IL
5,2005,Jun,66.7,62.9,6409402,6038327,371075,5.8,IL
6,2005,Jul,66.8,62.9,6415103,6048748,366355,5.7,IL
7,2005,Aug,66.8,63.0,6419959,6057981,361978,5.6,IL
8,2005,Sep,66.8,63.1,6424089,6066490,357599,5.6,IL
9,2005,Oct,66.7,63.1,6428364,6076025,352339,5.5,IL
10,2005,Nov,66.7,63.1,6433630,6087174,346456,5.4,IL
11,2005,Dec,66.7,63.2,6439468,6099998,339470,5.3,IL
12,2006,Jan,66.8,63.4,6446086,6115270,330816,5.1,IL
13,2006,Feb,66.8,63.5,6453903,6133097,320806,5.0,IL
14,2006,Mar,66.9,63.7,6463382,6152425,310957,4.8,IL
15,2006,Apr,67.0,63.9,6474739,6171881,302858,4.7,IL
16,2006,May,67.1,64.1,6488248,6191538,296710,4.6,IL
17,2006,Jun,67.3,64.2,6503286,6210984,292302,4.5,IL
18,2006,Jul,67.4,64.4,6519819,6230966,288853,4.4,IL
19,2006,Aug,67.5,64.6,6537794,6251061,286733,4.4,IL
20,2006,Sep,67.7,64.7,6555585,6268521,287064,4.4,IL
21,2006,Oct,67.8,64.8,6570891,6281776,289115,4.4,IL
22,2006,Nov,67.8,64.8,6581859,6289937,291922,4.4,IL
23,2006,Dec,67.9,64.8,6587537,6292132,295405,4.5,IL
24,2007,Jan,67.8,64.8,6589487,6289431,300056,4.6,IL
25,2007,Feb,67.8,64.7,6591137,6285513,305624,4.6,IL
26,2007,Mar,67.8,64.6,6594491,6283126,311365,4.7,IL
27,2007,Apr,67.9,64.6,6601114,6284088,317026,4.8,IL
28,2007,May,67.9,64.6,6612003,6288680,323323,4.9,IL
29,2007,Jun,68.0,64.6,6626590,6295927,330663,5.0,IL
30,2007,Jul,68.2,64.7,6643166,6304082,339084,5.1,IL
31,2007,Aug,68.3,64.7,6659740,6311421,348319,5.2,IL
32,2007,Sep,68.4,64.7,6674906,6317812,357094,5.3,IL
33,2007,Oct,68.5,64.7,6687735,6322851,364884,5.5,IL
34,2007,Nov,68.5,64.8,6697912,6327482,370430,5.5,IL
35,2007,Dec,68.6,64.8,6705536,6332204,373332,5.6,IL
36,2008,Jan,68.6,64.8,6709673,6334043,375630,5.6,IL
37,2008,Feb,68.6,64.7,6708900,6329578,379322,5.7,IL
38,2008,Mar,68.5,64.5,6703482,6317160,386322,5.8,IL
39,2008,Apr,68.3,64.3,6694126,6297079,397047,5.9,IL
40,2008,May,68.2,64.0,6681135,6270759,410376,6.1,IL
41,2008,Jun,68.0,63.6,6665433,6241078,424355,6.4,IL
42,2008,Jul,67.7,63.3,6647982,6211153,436829,6.6,IL
43,2008,Aug,67.5,63.0,6630290,6183599,446691,6.7,IL
44,2008,Sep,67.3,62.7,6614614,6158416,456198,6.9,IL
45,2008,Oct,67.1,62.4,6602533,6133051,469482,7.1,IL
46,2008,Nov,67.0,62.0,6594077,6104242,489835,7.4,IL
47,2008,Dec,66.9,61.7,6589361,6071369,517992,7.9,IL
48,2009,Jan,66.9,61.3,6588346,6037014,551332,8.4,IL
49,2009,Feb,66.9,60.9,6591950,6005570,586380,8.9,IL
50,2009,Mar,66.9,60.7,6599816,5981260,618556,9.4,IL
51,2009,Apr,67.0,60.5,6609226,5964724,644502,9.8,IL
52,2009,May,67.1,60.3,6616824,5952614,664210,10.0,IL
53,2009,Jun,67.1,60.2,6620584,5941437,679147,10.3,IL
54,2009,Jul,67.0,60.0,6618475,5927060,691415,10.4,IL
55,2009,Aug,66.9,59.8,6610820,5907507,703313,10.6,IL
56,2009,Sep,66.7,59.5,6601019,5885181,715838,10.8,IL
57,2009,Oct,66.6,59.3,6593339,5864865,728474,11.0,IL
58,2009,Nov,66.6,59.1,6592973,5852392,740581,11.2,IL
59,2009,Dec,66.6,59.1,6601820,5851687,750133,11.4,IL
60,2010,Jan,66.8,59.1,6616172,5862132,754040,11.4,IL
61,2010,Feb,66.9,59.3,6628765,5878039,750726,11.3,IL
62,2010,Mar,66.9,59.4,6634842,5894031,740811,11.2,IL
63,2010,Apr,67.1,59.8,6634091,5907874,726217,10.9,IL
64,2010,May,67.0,59.9,6627042,5918616,708426,10.7,IL
65,2010,Jun,66.9,59.9,6615981,5925185,690796,10.4,IL
66,2010,Jul,66.8,59.9,6605960,5929180,676780,10.2,IL
67,2010,Aug,66.7,59.9,6600053,5933099,666954,10.1,IL
68,2010,Sep,66.6,59.9,6596284,5936658,659626,10.0,IL
69,2010,Oct,66.5,59.9,6592116,5939556,652560,9.9,IL
70,2010,Nov,66.4,59.9,6584845,5940621,644224,9.8,IL
71,2010,Dec,66.3,59.8,6573920,5938573,635347,9.7,IL
72,2011,Jan,66.1,59.8,6562937,5934625,628312,9.6,IL
73,2011,Feb,66.0,59.7,6554409,5929766,624643,9.5,IL
74,2011,Mar,65.9,59.6,6548847,5923813,625034,9.5,IL
75,2011,Apr,65.9,59.5,6547150,5917025,630125,9.6,IL
76,2011,May,65.9,59.5,6550817,5911356,639461,9.8,IL
77,2011,Jun,65.9,59.4,6558897,5908670,650227,9.9,IL
78,2011,Jul,66.0,59.4,6568779,5909893,658886,10.0,IL
79,2011,Aug,66.1,59.4,6577947,5914841,663106,10.1,IL
80,2011,Sep,66.1,59.5,6585180,5924042,661138,10.0,IL
81,2011,Oct,66.1,59.6,6589604,5936827,652777,9.9,IL
82,2011,Nov,66.1,59.7,6590025,5950626,639399,9.7,IL
83,2011,Dec,66.1,59.8,6586549,5962923,623626,9.5,IL
84,2012,Jan,66.0,59.9,6580816,5972028,608788,9.3,IL
85,2012,Feb,65.9,59.9,6576290,5978214,598076,9.1,IL
86,2012,Mar,65.9,59.9,6574536,5981261,593275,9.0,IL
87,2012,Apr,65.8,59.9,6574291,5981264,593027,9.0,IL
88,2012,May,65.8,59.9,6576078,5981247,594831,9.0,IL
89,2012,Jun,65.9,59.9,6579685,5983696,595989,9.1,IL
90,2012,Jul,65.9,59.9,6583994,5989315,594679,9.0,IL
91,2012,Aug,65.9,60.0,6588983,5997041,591942,9.0,IL
92,2012,Sep,65.9,60.0,6594683,6003932,590751,9.0,IL
93,2012,Oct,65.9,60.0,6598498,6006076,592422,9.0,IL
94,2012,Nov,65.9,60.0,6598094,6001684,596410,9.0,IL
95,2012,Dec,65.8,59.8,6592899,5991770,601129,9.1,IL
96,2013,Jan,65.7,59.7,6584280,5978819,605461,9.2,IL
97,2013,Feb,65.6,59.6,6574749,5966349,608400,9.3,IL
98,2013,Mar,65.6,59.5,6567333,5958222,609111,9.3,IL
99,2013,Apr,65.5,59.4,6564365,5956555,607810,9.3,IL
100,2013,May,65.5,59.4,6564150,5958543,605607,9.2,IL
101,2013,Jun,65.5,59.5,6564252,5960949,603303,9.2,IL
102,2013,Jul,65.4,59.4,6562584,5961642,600942,9.2,IL
103,2013,Aug,65.4,59.4,6556695,5960397,596298,9.1,IL
104,2013,Sep,65.2,59.4,6547345,5959101,588244,9.0,IL
105,2013,Oct,65.2,59.4,6539322,5960606,578716,8.8,IL
106,2013,Nov,65.1,59.4,6536335,5967239,569096,8.7,IL
107,2013,Dec,65.1,59.5,6537549,5978331,559218,8.6,IL
108,2014,Jan,65.1,59.7,6539433,5991934,547499,8.4,IL
109,2014,Feb,65.1,59.8,6539294,6006418,532876,8.1,IL
110,2014,Mar,65.1,59.9,6535796,6019511,516285,7.9,IL
111,2014,Apr,65.0,60.0,6528094,6029065,499029,7.6,IL
112,2014,May,64.9,60.1,6518261,6036226,482035,7.4,IL
113,2014,Jun,64.8,60.1,6510457,6043882,466575,7.2,IL
114,2014,Jul,64.7,60.2,6506321,6053007,453314,7.0,IL
115,2014,Aug,64.7,60.3,6505638,6063338,442300,6.8,IL
116,2014,Sep,64.7,60.4,6506203,6073599,432604,6.6,IL
117,2014,Oct,64.7,60.5,6504445,6081936,422509,6.5,IL
118,2014,Nov,64.6,60.5,6498807,6086861,411946,6.3,IL
119,2014,Dec,64.6,60.6,6492057,6089359,402698,6.2,IL
120,2015,Jan,64.5,60.6,6487628,6091476,396152,6.1,IL
121,2015,Feb,64.5,60.6,6487282,6094125,393157,6.1,IL
122,2015,Mar,64.6,60.7,6491517,6098798,392719,6.0,IL
123,2015,Apr,64.7,60.7,6499013,6106082,392931,6.0,IL
124,2015,May,64.7,60.8,6506301,6114433,391868,6.0,IL
125,2015,Jun,64.8,60.9,6510435,6121275,389160,6.0,IL
126,2015,Jul,64.8,60.9,6511967,6125787,386180,5.9,IL
127,2015,Aug,64.8,61.0,6513391,6128765,384626,5.9,IL
128,2015,Sep,64.8,61.0,6517227,6132095,385132,5.9,IL
129,2015,Oct,64.9,61.1,6526537,6138315,388222,5.9,IL
130,2015,Nov,65.1,61.2,6542574,6148366,394208,6.0,IL
131,2015,Dec,65.3,61.3,6561973,6160489,401484,6.1,IL
132,2016,Jan,65.5,61.4,6579309,6171894,407415,6.2,IL
133,2016,Feb,65.6,61.5,6590470,6180514,409956,6.2,IL
134,2016,Mar,65.6,61.6,6593404,6185600,407804,6.2,IL
135,2016,Apr,65.6,61.6,6589117,6186891,402226,6.1,IL
136,2016,May,65.5,61.6,6580544,6184932,395612,6.0,IL
137,2016,Jun,65.4,61.5,6569841,6180798,389043,5.9,IL
138,2016,Jul,65.3,61.5,6558534,6175653,382881,5.8,IL
139,2016,Aug,65.2,61.4,6548208,6170083,378125,5.8,IL
140,2016,Sep,65.1,61.3,6539107,6164292,374815,5.7,IL
141,2016,Oct,65.0,61.3,6529612,6158816,370796,5.7,IL
142,2016,Nov,64.9,61.3,6518407,6154569,363838,5.6,IL
143,2016,Dec,64.8,61.2,6506520,6152559,353961,5.4,IL
144,2017,Jan,64.7,61.3,6565989,6219411,346578,5.3,IL
145,2017,Feb,64.7,61.4,6559916,6223864,336052,5.1,IL
146,2017,Mar,64.7,61.4,6556181,6227973,328208,5.0,IL
147,2017,Apr,64.6,61.4,6555108,6231214,323894,4.9,IL
148,2017,May,64.7,61.5,6556293,6233870,322423,4.9,IL
149,2017,Jun,64.7,61.5,6558948,6235783,323165,4.9,IL
150,2017,Jul,64.7,61.5,6562474,6237591,324883,5.0,IL
151,2017,Aug,64.7,61.5,6564703,6239573,325130,5.0,IL
152,2017,Sep,64.7,61.5,6564712,6241648,323064,4.9,IL
153,2017,Oct,64.7,61.6,6563820,6244566,319254,4.9,IL
154,2017,Nov,64.7,61.6,6562511,6248693,313818,4.8,IL
155,2017,Dec,64.7,61.7,6561498,6255004,306494,4.7,IL
156,2018,Jan,64.7,61.8,6561374,6262881,298493,4.5,IL
157,2018,Feb,64.7,61.9,6563449,6272116,291333,4.4,IL
158,2018,Mar,64.8,62.0,6566992,6281251,285741,4.4,IL
159,2018,Apr,64.8,62.0,6569254,6287695,281559,4.3,IL
160,2018,May,64.8,62.1,6569189,6289884,279305,4.3,IL
161,2018,Jun,64.8,62.1,6567583,6288689,278894,4.2,IL
162,2018,Jul,64.8,62.0,6564878,6285128,279750,4.3,IL
163,2018,Aug,64.8,62.0,6563463,6281315,282148,4.3,IL
164,2018,Sep,64.8,62.0,6565242,6279194,286048,4.4,IL
165,2018,Oct,64.8,62.0,6569928,6279203,290725,4.4,IL
166,2018,Nov,64.9,62.0,6577331,6281626,295705,4.5,IL
167,2018,Dec,65.0,62.0,6586203,6286600,299603,4.5,IL
168,2019,Jan,65.1,62.1,6593252,6293474,299778,4.5,IL
169,2019,Feb,65.1,62.2,6595848,6301234,294614,4.5,IL
170,2019,Mar,65.1,62.3,6593937,6308977,284960,4.3,IL
171,2019,Apr,65.1,62.4,6589245,6316328,272917,4.1,IL
172,2019,May,65.0,62.4,6582561,6321220,261341,4.0,IL
173,2019,Jun,64.9,62.4,6574663,6321983,252680,3.8,IL
174,2019,Jul,64.9,62.4,6566348,6318411,247937,3.8,IL
175,2019,Aug,64.8,62.3,6557785,6312165,245620,3.7,IL
176,2019,Sep,64.7,62.3,6549457,6306669,242788,3.7,IL
177,2019,Oct,64.6,62.3,6542614,6303262,239352,3.7,IL
178,2019,Nov,64.6,62.2,6537086,6300771,236315,3.6,IL
179,2019,Dec,64.5,62.2,6530652,6294968,235684,3.6,IL
180,2020,Jan,64.5,62.1,6524806,6285392,239414,3.7,IL
181,2020,Feb,64.5,62.0,6521872,6273767,248105,3.8,IL
182,2020,Mar,64.0,60.8,6473214,6153567,319647,4.9,IL
183,2020,Apr,63.0,52.0,6366967,5258756,1108211,17.4,IL
184,2020,May,63.1,53.9,6376437,5450216,926221,14.5,IL
185,2020,Jun,62.7,54.7,6329994,5528036,801958,12.7,IL
186,2020,Jul,62.8,55.6,6342576,5613618,728958,11.5,IL
187,2020,Aug,62.4,56.2,6296387,5677310,619077,9.8,IL
188,2020,Sep,62.5,56.8,6304803,5734503,570300,9.0,IL
189,2020,Oct,62.3,57.2,6278117,5767334,510783,8.1,IL
190,2020,Nov,62.3,57.5,6277488,5792044,485444,7.7,IL
191,2020,Dec,62.4,57.7,6282992,5812387,470605,7.5,IL
192,2021,Jan,62.3,57.9,6274598,5830102,444496,7.1,IL
193,2021,Feb,62.4,58.1,6280559,5847051,433508,6.9,IL
194,2021,Mar,62.6,58.3,6289392,5865671,423721,6.7,IL
195,2021,Apr,62.7,58.6,6302026,5883090,418936,6.6,IL
196,2021,May,62.8,58.7,6307602,5899080,408522,6.5,IL
197,2021,Jun,63.0,58.9,6321192,5913068,408124,6.5,IL
198,2021,Jul,63.0,59.1,6323582,5929507,394075,6.2,IL
199,2021,Aug,63.1,59.3,6330348,5953583,376765,6.0,IL
200,2021,Sep,63.1,59.6,6332171,5980989,351182,5.5,IL
201,2021,Oct,63.3,59.9,6343551,6009011,334540,5.3,IL
202,2021,Nov,63.2,60.0,6341105,6015878,325227,5.1,IL
203,2021,Dec,63.3,60.0,6339764,6015254,324510,5.1,IL
204,2022,Jan,63.7,60.5,6377956,6060418,317538,5.0,IL
205,2022,Feb,63.9,60.9,6403328,6094873,308455,4.8,IL
206,2022,Mar,64.2,61.3,6430581,6131508,299073,4.7,IL
207,2022,Apr,64.5,61.5,6449597,6153325,296272,4.6,IL
208,2022,May,64.6,61.7,6464674,6167065,297609,4.6,IL
209,2022,Jun,64.6,61.7,6462010,6171533,290477,4.5,IL
210,2022,Jul,64.6,61.8,6459677,6172583,287094,4.4,IL
211,2022,Aug,64.6,61.7,6458390,6168363,290027,4.5,IL
212,2022,Sep,64.5,61.6,6447007,6156469,290538,4.5,IL
213,2022,Oct,64.4,61.4,6436071,6137969,298102,4.6,IL
214,2022,Nov,64.3,61.3,6423469,6120160,303309,4.7,IL
0,2005,Jan,68.5,63.0,318752,293054,25698,8.1,DC
1,2005,Feb,68.6,63.1,318917,293742,25175,7.9,DC
2,2005,Mar,68.5,63.3,318932,294414,24518,7.7,DC
3,2005,Apr,68.5,63.4,318871,295106,23765,7.5,DC
4,2005,May,68.4,63.5,318779,295824,22955,7.2,DC
5,2005,Jun,68.3,63.6,318597,296442,22155,7.0,DC
6,2005,Jul,68.2,63.6,318296,296852,21444,6.7,DC
7,2005,Aug,68.1,63.6,317895,297042,20853,6.6,DC
8,2005,Sep,68.0,63.6,317511,297111,20400,6.4,DC
9,2005,Oct,67.8,63.5,317260,297190,20070,6.3,DC
10,2005,Nov,67.7,63.5,317081,297209,19872,6.3,DC
11,2005,Dec,67.6,63.4,316887,297103,19784,6.2,DC
12,2006,Jan,67.6,63.4,316908,297153,19755,6.2,DC
13,2006,Feb,67.6,63.4,317249,297468,19781,6.2,DC
14,2006,Mar,67.7,63.5,317859,297973,19886,6.3,DC
15,2006,Apr,67.8,63.6,318547,298467,20080,6.3,DC
16,2006,May,68.0,63.6,319246,298941,20305,6.4,DC
17,2006,Jun,68.1,63.7,320029,299536,20493,6.4,DC
18,2006,Jul,68.3,63.9,320865,300268,20597,6.4,DC
19,2006,Aug,68.4,64.0,321679,301037,20642,6.4,DC
20,2006,Sep,68.5,64.1,322404,301755,20649,6.4,DC
21,2006,Oct,68.6,64.2,323040,302460,20580,6.4,DC
22,2006,Nov,68.7,64.4,323706,303280,20426,6.3,DC
23,2006,Dec,68.8,64.5,324467,304268,20199,6.2,DC
24,2007,Jan,68.9,64.7,325086,305135,19951,6.1,DC
25,2007,Feb,68.9,64.8,325363,305635,19728,6.1,DC
26,2007,Mar,68.9,64.8,325327,305806,19521,6.0,DC
27,2007,Apr,68.8,64.7,325132,305789,19343,5.9,DC
28,2007,May,68.7,64.7,324944,305707,19237,5.9,DC
29,2007,Jun,68.7,64.6,324893,305688,19205,5.9,DC
30,2007,Jul,68.7,64.7,325257,306040,19217,5.9,DC
31,2007,Aug,68.9,64.8,326098,306820,19278,5.9,DC
32,2007,Sep,69.0,65.0,327267,307902,19365,5.9,DC
33,2007,Oct,69.2,65.1,328517,309035,19482,5.9,DC
34,2007,Nov,69.4,65.3,329628,310023,19605,5.9,DC
35,2007,Dec,69.6,65.4,330482,310744,19738,6.0,DC
36,2008,Jan,69.6,65.4,331102,311186,19916,6.0,DC
37,2008,Feb,69.7,65.5,331607,311454,20153,6.1,DC
38,2008,Mar,69.8,65.5,332201,311711,20490,6.2,DC
39,2008,Apr,69.9,65.5,333093,312148,20945,6.3,DC
40,2008,May,70.1,65.6,334242,312748,21494,6.4,DC
41,2008,Jun,70.3,65.7,335385,313270,22115,6.6,DC
42,2008,Jul,70.4,65.7,336209,313420,22789,6.8,DC
43,2008,Aug,70.4,65.5,336627,313128,23499,7.0,DC
44,2008,Sep,70.3,65.2,336743,312433,24310,7.2,DC
45,2008,Oct,70.2,64.9,336687,311389,25298,7.5,DC
46,2008,Nov,70.0,64.5,336494,310042,26452,7.9,DC
47,2008,Dec,69.9,64.1,336200,308470,27730,8.2,DC
48,2009,Jan,69.7,63.7,335894,306831,29063,8.7,DC
49,2009,Feb,69.6,63.3,335788,305415,30373,9.0,DC
50,2009,Mar,69.5,63.0,335960,304404,31556,9.4,DC
51,2009,Apr,69.5,62.7,336315,303758,32557,9.7,DC
52,2009,May,69.5,62.6,336836,303415,33421,9.9,DC
53,2009,Jun,69.5,62.5,337534,303335,34199,10.1,DC
54,2009,Jul,69.6,62.4,338299,303415,34884,10.3,DC
55,2009,Aug,69.6,62.3,339054,303600,35454,10.5,DC
56,2009,Sep,69.6,62.2,339661,303787,35874,10.6,DC
57,2009,Oct,69.5,62.1,340006,303892,36114,10.6,DC
58,2009,Nov,69.5,62.1,340324,304115,36209,10.6,DC
59,2009,Dec,69.5,62.1,340983,304827,36156,10.6,DC
60,2010,Jan,69.6,62.3,342135,306215,35920,10.5,DC
61,2010,Feb,69.8,62.6,343633,308102,35531,10.3,DC
62,2010,Mar,70.0,62.9,345142,310074,35068,10.2,DC
63,2010,Apr,69.0,62.1,346457,311849,34608,10.0,DC
64,2010,May,69.0,62.2,347407,313225,34182,9.8,DC
65,2010,Jun,69.0,62.3,347887,314012,33875,9.7,DC
66,2010,Jul,68.9,62.2,347929,314145,33784,9.7,DC
67,2010,Aug,68.7,62.0,347691,313803,33888,9.7,DC
68,2010,Sep,68.5,61.8,347532,313433,34099,9.8,DC
69,2010,Oct,68.4,61.6,347817,313491,34326,9.9,DC
70,2010,Nov,68.4,61.6,348530,314014,34516,9.9,DC
71,2010,Dec,68.4,61.6,349451,314772,34679,9.9,DC
72,2011,Jan,68.5,61.6,350280,315386,34894,10.0,DC
73,2011,Feb,68.4,61.6,350793,315584,35209,10.0,DC
74,2011,Mar,68.4,61.4,351005,315406,35599,10.1,DC
75,2011,Apr,68.2,61.2,351063,315027,36036,10.3,DC
76,2011,May,68.1,61.1,351149,314685,36464,10.4,DC
77,2011,Jun,68.0,60.9,351373,314624,36749,10.5,DC
78,2011,Jul,68.0,60.9,351799,315004,36795,10.5,DC
79,2011,Aug,68.0,60.9,352408,315803,36605,10.4,DC
80,2011,Sep,68.0,61.0,353073,316859,36214,10.3,DC
81,2011,Oct,68.0,61.1,353701,317989,35712,10.1,DC
82,2011,Nov,68.0,61.2,354283,319110,35173,9.9,DC
83,2011,Dec,68.0,61.3,354889,320236,34653,9.8,DC
84,2012,Jan,68.0,61.5,355798,321609,34189,9.6,DC
85,2012,Feb,68.2,61.7,357117,323319,33798,9.5,DC
86,2012,Mar,68.3,62.0,358725,325222,33503,9.3,DC
87,2012,Apr,68.6,62.2,360448,327187,33261,9.2,DC
88,2012,May,68.8,62.5,362204,329200,33004,9.1,DC
89,2012,Jun,69.0,62.8,364042,331349,32693,9.0,DC
90,2012,Jul,69.3,63.1,365996,333656,32340,8.8,DC
91,2012,Aug,69.5,63.4,368008,335940,32068,8.7,DC
92,2012,Sep,69.7,63.7,369988,338002,31986,8.6,DC
93,2012,Oct,69.9,63.9,371781,339713,32068,8.6,DC
94,2012,Nov,70.1,64.0,373228,340978,32250,8.6,DC
95,2012,Dec,70.2,64.1,374209,341766,32443,8.7,DC
96,2013,Jan,70.1,64.0,374703,342127,32576,8.7,DC
97,2013,Feb,70.1,64.0,374879,342281,32598,8.7,DC
98,2013,Mar,69.9,63.9,374852,342391,32461,8.7,DC
99,2013,Apr,69.8,63.8,374770,342590,32180,8.6,DC
100,2013,May,69.7,63.7,374621,342718,31903,8.5,DC
101,2013,Jun,69.5,63.6,374318,342566,31752,8.5,DC
102,2013,Jul,69.3,63.4,373956,342280,31676,8.5,DC
103,2013,Aug,69.1,63.3,373632,342129,31503,8.4,DC
104,2013,Sep,69.0,63.2,373434,342277,31157,8.3,DC
105,2013,Oct,68.9,63.3,373515,342762,30753,8.2,DC
106,2013,Nov,68.9,63.3,373797,343424,30373,8.1,DC
107,2013,Dec,68.9,63.3,374139,344093,30046,8.0,DC
108,2014,Jan,68.8,63.4,374474,344720,29754,7.9,DC
109,2014,Feb,68.8,63.4,374892,345390,29502,7.9,DC
110,2014,Mar,68.9,63.5,375490,346115,29375,7.8,DC
111,2014,Apr,68.9,63.5,376260,346875,29385,7.8,DC
112,2014,May,69.0,63.7,377323,347911,29412,7.8,DC
113,2014,Jun,69.2,63.9,378844,349461,29383,7.8,DC
114,2014,Jul,69.4,64.1,380511,351174,29337,7.7,DC
115,2014,Aug,69.6,64.3,382074,352769,29305,7.7,DC
116,2014,Sep,69.7,64.4,383397,354127,29270,7.6,DC
117,2014,Oct,69.8,64.5,384299,355165,29134,7.6,DC
118,2014,Nov,69.8,64.6,384899,356027,28872,7.5,DC
119,2014,Dec,69.8,64.6,385365,356775,28590,7.4,DC
120,2015,Jan,69.7,64.6,385655,357301,28354,7.4,DC
121,2015,Feb,69.7,64.6,385829,357663,28166,7.3,DC
122,2015,Mar,69.6,64.6,386175,358225,27950,7.2,DC
123,2015,Apr,69.6,64.7,386792,359132,27660,7.2,DC
124,2015,May,69.7,64.8,387466,360162,27304,7.0,DC
125,2015,Jun,69.7,64.8,388031,361107,26924,6.9,DC
126,2015,Jul,69.7,64.9,388585,362003,26582,6.8,DC
127,2015,Aug,69.7,65.0,389198,362893,26305,6.8,DC
128,2015,Sep,69.7,65.0,389790,363732,26058,6.7,DC
129,2015,Oct,69.7,65.1,390400,364559,25841,6.6,DC
130,2015,Nov,69.8,65.2,391107,365451,25656,6.6,DC
131,2015,Dec,69.8,65.3,391856,366441,25415,6.5,DC
132,2016,Jan,69.9,65.4,392658,367573,25085,6.4,DC
133,2016,Feb,70.0,65.6,393390,368673,24717,6.3,DC
134,2016,Mar,70.0,65.6,393876,369514,24362,6.2,DC
135,2016,Apr,69.9,65.6,394058,369933,24125,6.1,DC
136,2016,May,69.9,65.6,394222,370141,24081,6.1,DC
137,2016,Jun,69.8,65.6,394519,370323,24196,6.1,DC
138,2016,Jul,69.8,65.5,394943,370549,24394,6.2,DC
139,2016,Aug,69.9,65.5,395512,370878,24634,6.2,DC
140,2016,Sep,69.9,65.5,396280,371384,24896,6.3,DC
141,2016,Oct,70.0,65.6,397144,372053,25091,6.3,DC
142,2016,Nov,70.1,65.6,397931,372781,25150,6.3,DC
143,2016,Dec,70.1,65.7,398689,373585,25104,6.3,DC
144,2017,Jan,70.1,65.8,390087,365688,24399,6.3,DC
145,2017,Feb,70.2,65.9,390854,366529,24325,6.2,DC
146,2017,Mar,70.3,66.0,391575,367300,24275,6.2,DC
147,2017,Apr,70.4,66.1,392397,368146,24251,6.2,DC
148,2017,May,70.5,66.2,393227,369006,24221,6.2,DC
149,2017,Jun,70.6,66.3,393872,369704,24168,6.1,DC
150,2017,Jul,70.6,66.3,394348,370273,24075,6.1,DC
151,2017,Aug,70.6,66.3,394563,370657,23906,6.1,DC
152,2017,Sep,70.6,66.3,394548,370865,23683,6.0,DC
153,2017,Oct,70.5,66.3,394486,371013,23473,6.0,DC
154,2017,Nov,70.5,66.3,394554,371205,23349,5.9,DC
155,2017,Dec,70.5,66.3,394839,371560,23279,5.9,DC
156,2018,Jan,70.6,66.4,395364,372122,23242,5.9,DC
157,2018,Feb,70.7,66.6,396276,373075,23201,5.9,DC
158,2018,Mar,70.9,66.7,397285,374178,23107,5.8,DC
159,2018,Apr,70.9,66.8,397756,374862,22894,5.8,DC
160,2018,May,70.8,66.8,397461,374914,22547,5.7,DC
161,2018,Jun,70.6,66.7,396555,374476,22079,5.6,DC
162,2018,Jul,70.4,66.5,395373,373837,21536,5.4,DC
163,2018,Aug,70.2,66.4,394414,373243,21171,5.4,DC
164,2018,Sep,70.1,66.3,393980,372761,21219,5.4,DC
165,2018,Oct,70.1,66.2,394255,372564,21691,5.5,DC
166,2018,Nov,70.3,66.3,395212,372799,22413,5.7,DC
167,2018,Dec,70.5,66.4,396604,373470,23134,5.8,DC
168,2019,Jan,70.7,66.6,398028,374441,23587,5.9,DC
169,2019,Feb,70.9,66.7,399136,375540,23596,5.9,DC
170,2019,Mar,71.1,66.9,399842,376646,23196,5.8,DC
171,2019,Apr,71.1,67.1,400365,377849,22516,5.6,DC
172,2019,May,71.2,67.3,400672,378895,21777,5.4,DC
173,2019,Jun,71.2,67.4,400750,379622,21128,5.3,DC
174,2019,Jul,71.1,67.5,400599,379971,20628,5.1,DC
175,2019,Aug,71.1,67.5,400446,380188,20258,5.1,DC
176,2019,Sep,71.1,67.6,400747,380795,19952,5.0,DC
177,2019,Oct,71.3,67.7,401616,381740,19876,4.9,DC
178,2019,Nov,71.5,67.9,402899,382766,20133,5.0,DC
179,2019,Dec,71.7,68.0,404205,383505,20700,5.1,DC
180,2020,Jan,71.8,68.0,405108,383707,21401,5.3,DC
181,2020,Feb,71.8,67.9,405242,383231,22011,5.4,DC
182,2020,Mar,71.4,67.5,402994,380679,22315,5.5,DC
183,2020,Apr,68.9,61.3,389035,345895,43140,11.1,DC
184,2020,May,67.5,61.4,380731,346476,34255,9.0,DC
185,2020,Jun,67.5,61.5,380892,347301,33591,8.8,DC
186,2020,Jul,67.9,61.9,383640,349278,34362,9.0,DC
187,2020,Aug,68.3,62.3,384652,350856,33796,8.8,DC
188,2020,Sep,68.7,62.7,385878,352288,33590,8.7,DC
189,2020,Oct,68.6,63.0,384292,352602,31690,8.2,DC
190,2020,Nov,68.5,63.1,382445,352533,29912,7.8,DC
191,2020,Dec,68.3,63.2,380455,351999,28456,7.5,DC
192,2021,Jan,68.0,63.3,377559,351348,26211,6.9,DC
193,2021,Feb,67.9,63.4,376087,351076,25011,6.7,DC
194,2021,Mar,68.2,63.7,376646,351633,25013,6.6,DC
195,2021,Apr,68.7,64.1,378292,352631,25661,6.8,DC
196,2021,May,69.4,64.5,380511,354110,26401,6.9,DC
197,2021,Jun,70.1,65.0,383400,355729,27671,7.2,DC
198,2021,Jul,70.5,65.5,384615,357444,27171,7.1,DC
199,2021,Aug,70.9,66.0,385724,359101,26623,6.9,DC
200,2021,Sep,70.9,66.3,385061,360197,24864,6.5,DC
201,2021,Oct,71.1,66.7,385285,361082,24203,6.3,DC
202,2021,Nov,71.2,66.8,384477,361009,23468,6.1,DC
203,2021,Dec,71.3,67.0,384289,360828,23461,6.1,DC
204,2022,Jan,71.7,67.2,385288,360973,24315,6.3,DC
205,2022,Feb,71.8,67.5,384825,361460,23365,6.1,DC
206,2022,Mar,72.1,67.8,385347,362341,23006,6.0,DC
207,2022,Apr,72.4,68.2,385597,363389,22208,5.8,DC
208,2022,May,72.7,68.6,386366,364471,21895,5.7,DC
209,2022,Jun,72.9,68.9,386265,365140,21125,5.5,DC
210,2022,Jul,73.0,69.2,385661,365773,19888,5.2,DC
211,2022,Aug,73.0,69.3,385046,365230,19816,5.1,DC
212,2022,Sep,72.7,69.2,382168,364120,18048,4.7,DC
213,2022,Oct,72.5,69.0,380243,361977,18266,4.8,DC
214,2022,Nov,72.0,68.6,376726,359268,17458,4.6,DC
0,2005,Jan,67.1,64.2,1201124,1149962,51162,4.3,NV
1,2005,Feb,67.2,64.3,1205680,1154565,51115,4.2,NV
2,2005,Mar,67.2,64.4,1210546,1159620,50926,4.2,NV
3,2005,Apr,67.3,64.5,1215779,1165081,50698,4.2,NV
4,2005,May,67.5,64.7,1221363,1170797,50566,4.1,NV
5,2005,Jun,67.6,64.8,1227044,1176365,50679,4.1,NV
6,2005,Jul,67.7,64.9,1232503,1181486,51017,4.1,NV
7,2005,Aug,67.8,65.0,1237385,1186098,51287,4.1,NV
8,2005,Sep,67.8,65.0,1241575,1190337,51238,4.1,NV
9,2005,Oct,67.7,65.0,1245346,1194538,50808,4.1,NV
10,2005,Nov,67.7,65.0,1249182,1198920,50262,4.0,NV
11,2005,Dec,67.7,65.0,1253457,1203581,49876,4.0,NV
12,2006,Jan,67.8,65.1,1258441,1208656,49785,4.0,NV
13,2006,Feb,67.9,65.2,1264123,1214044,50079,4.0,NV
14,2006,Mar,68.1,65.4,1270318,1219558,50760,4.0,NV
15,2006,Apr,68.2,65.5,1276714,1225043,51671,4.0,NV
16,2006,May,68.4,65.6,1282975,1230505,52470,4.1,NV
17,2006,Jun,68.5,65.7,1288880,1235957,52923,4.1,NV
18,2006,Jul,68.6,65.8,1294646,1241605,53041,4.1,NV
19,2006,Aug,68.8,66.0,1300611,1247515,53096,4.1,NV
20,2006,Sep,68.9,66.1,1306774,1253515,53259,4.1,NV
21,2006,Oct,69.1,66.3,1312862,1259390,53472,4.1,NV
22,2006,Nov,69.2,66.4,1318570,1264827,53743,4.1,NV
23,2006,Dec,69.3,66.5,1323560,1269442,54118,4.1,NV
24,2007,Jan,69.3,66.5,1327708,1273015,54693,4.1,NV
25,2007,Feb,69.4,66.5,1331183,1275701,55482,4.2,NV
26,2007,Mar,69.3,66.4,1334075,1277645,56430,4.2,NV
27,2007,Apr,69.3,66.3,1336648,1279106,57542,4.3,NV
28,2007,May,69.3,66.2,1339270,1280394,58876,4.4,NV
29,2007,Jun,69.3,66.2,1342122,1281753,60369,4.5,NV
30,2007,Jul,69.3,66.1,1345169,1283216,61953,4.6,NV
31,2007,Aug,69.3,66.0,1348473,1284830,63643,4.7,NV
32,2007,Sep,69.4,66.0,1352002,1286632,65370,4.8,NV
33,2007,Oct,69.4,66.0,1355515,1288393,67122,5.0,NV
34,2007,Nov,69.5,66.0,1358745,1289934,68811,5.1,NV
35,2007,Dec,69.5,65.9,1361625,1291127,70498,5.2,NV
36,2008,Jan,69.5,65.9,1364101,1291670,72431,5.3,NV
37,2008,Feb,69.6,65.7,1366231,1291488,74743,5.5,NV
38,2008,Mar,69.5,65.6,1368224,1290616,77608,5.7,NV
39,2008,Apr,69.5,65.4,1370126,1289063,81063,5.9,NV
40,2008,May,69.5,65.2,1371914,1286907,85007,6.2,NV
41,2008,Jun,69.5,65.0,1373585,1284291,89294,6.5,NV
42,2008,Jul,69.5,64.7,1375054,1281173,93881,6.8,NV
43,2008,Aug,69.4,64.5,1376217,1277347,98870,7.2,NV
44,2008,Sep,69.4,64.2,1377125,1272537,104588,7.6,NV
45,2008,Oct,69.4,63.8,1377911,1266591,111320,8.1,NV
46,2008,Nov,69.4,63.4,1378359,1259504,118855,8.6,NV
47,2008,Dec,69.3,62.9,1378215,1251597,126618,9.2,NV
48,2009,Jan,69.2,62.5,1377435,1243320,134115,9.7,NV
49,2009,Feb,69.1,62.0,1376206,1235176,141030,10.2,NV
50,2009,Mar,69.0,61.6,1374816,1227786,147030,10.7,NV
51,2009,Apr,68.8,61.2,1373429,1221385,152044,11.1,NV
52,2009,May,68.7,60.9,1371955,1215496,156459,11.4,NV
53,2009,Jun,68.6,60.5,1370321,1209700,160621,11.7,NV
54,2009,Jul,68.4,60.2,1368177,1203710,164467,12.0,NV
55,2009,Aug,68.2,59.8,1365329,1197462,167867,12.3,NV
56,2009,Sep,68.0,59.5,1362186,1191275,170911,12.5,NV
57,2009,Oct,67.8,59.1,1359279,1185525,173754,12.8,NV
58,2009,Nov,67.6,58.8,1357494,1180770,176724,13.0,NV
59,2009,Dec,67.6,58.6,1357344,1177391,179953,13.3,NV
60,2010,Jan,67.6,58.5,1358406,1175465,182941,13.5,NV
61,2010,Feb,67.6,58.4,1359771,1174541,185230,13.6,NV
62,2010,Mar,67.6,58.4,1360604,1173988,186616,13.7,NV
63,2010,Apr,65.6,56.6,1360595,1173507,187088,13.8,NV
64,2010,May,65.5,56.5,1359713,1173032,186681,13.7,NV
65,2010,Jun,65.4,56.5,1358272,1172324,185948,13.7,NV
66,2010,Jul,65.3,56.4,1357070,1171332,185738,13.7,NV
67,2010,Aug,65.3,56.3,1356662,1170347,186315,13.7,NV
68,2010,Sep,65.2,56.2,1356846,1169573,187273,13.8,NV
69,2010,Oct,65.2,56.2,1357352,1169345,188007,13.9,NV
70,2010,Nov,65.2,56.2,1357786,1169711,188075,13.9,NV
71,2010,Dec,65.2,56.2,1357880,1170535,187345,13.8,NV
72,2011,Jan,65.1,56.2,1357776,1171682,186094,13.7,NV
73,2011,Feb,65.1,56.2,1357524,1172858,184666,13.6,NV
74,2011,Mar,65.0,56.3,1357202,1173836,183366,13.5,NV
75,2011,Apr,65.0,56.3,1357102,1174492,182610,13.5,NV
76,2011,May,65.0,56.3,1357610,1175043,182567,13.4,NV
77,2011,Jun,65.0,56.3,1358808,1175945,182863,13.5,NV
78,2011,Jul,65.1,56.3,1360553,1177623,182930,13.4,NV
79,2011,Aug,65.1,56.4,1362462,1180132,182330,13.4,NV
80,2011,Sep,65.0,56.4,1364043,1183282,180761,13.3,NV
81,2011,Oct,65.0,56.5,1364991,1186737,178254,13.1,NV
82,2011,Nov,64.9,56.6,1365040,1190017,175023,12.8,NV
83,2011,Dec,64.8,56.7,1364376,1192847,171529,12.6,NV
84,2012,Jan,64.7,56.7,1363603,1195245,168358,12.3,NV
85,2012,Feb,64.6,56.7,1363319,1197373,165946,12.2,NV
86,2012,Mar,64.5,56.7,1363757,1199248,164509,12.1,NV
87,2012,Apr,64.5,56.8,1364616,1200986,163630,12.0,NV
88,2012,May,64.5,56.8,1365728,1202977,162751,11.9,NV
89,2012,Jun,64.4,56.8,1366798,1205447,161351,11.8,NV
90,2012,Jul,64.4,56.9,1367483,1208382,159101,11.6,NV
91,2012,Aug,64.3,57.0,1367955,1211574,156381,11.4,NV
92,2012,Sep,64.3,57.0,1368573,1214739,153834,11.2,NV
93,2012,Oct,64.2,57.1,1369063,1217434,151629,11.1,NV
94,2012,Nov,64.1,57.1,1369310,1219490,149820,10.9,NV
95,2012,Dec,64.0,57.1,1369233,1220968,148265,10.8,NV
96,2013,Jan,64.0,57.1,1368931,1222071,146860,10.7,NV
97,2013,Feb,63.9,57.1,1368771,1223325,145446,10.6,NV
98,2013,Mar,63.8,57.1,1368999,1225232,143767,10.5,NV
99,2013,Apr,63.8,57.2,1369806,1227979,141827,10.4,NV
100,2013,May,63.8,57.3,1370943,1231067,139876,10.2,NV
101,2013,Jun,63.8,57.3,1372012,1233932,138080,10.1,NV
102,2013,Jul,63.7,57.4,1372712,1236337,136375,9.9,NV
103,2013,Aug,63.6,57.4,1372608,1238307,134301,9.8,NV
104,2013,Sep,63.5,57.4,1371772,1240084,131688,9.6,NV
105,2013,Oct,63.3,57.4,1371166,1242032,129134,9.4,NV
106,2013,Nov,63.2,57.4,1371342,1244462,126880,9.3,NV
107,2013,Dec,63.2,57.4,1372217,1247354,124863,9.1,NV
108,2014,Jan,63.2,57.5,1373421,1250571,122850,8.9,NV
109,2014,Feb,63.1,57.6,1374578,1253863,120715,8.8,NV
110,2014,Mar,63.1,57.7,1375605,1256934,118671,8.6,NV
111,2014,Apr,63.0,57.7,1376354,1259583,116771,8.5,NV
112,2014,May,63.0,57.7,1376943,1262099,114844,8.3,NV
113,2014,Jun,62.9,57.8,1377865,1264946,112919,8.2,NV
114,2014,Jul,62.9,57.8,1379296,1268140,111156,8.1,NV
115,2014,Aug,62.9,57.9,1381318,1271663,109655,7.9,NV
116,2014,Sep,62.9,58.0,1383739,1275356,108383,7.8,NV
117,2014,Oct,62.9,58.0,1385877,1278928,106949,7.7,NV
118,2014,Nov,62.8,58.1,1387386,1282078,105308,7.6,NV
119,2014,Dec,62.8,58.1,1388719,1284896,103823,7.5,NV
120,2015,Jan,62.7,58.1,1390075,1287564,102511,7.4,NV
121,2015,Feb,62.7,58.1,1391547,1290189,101358,7.3,NV
122,2015,Mar,62.7,58.2,1393136,1292980,100156,7.2,NV
123,2015,Apr,62.7,58.2,1394785,1295937,98848,7.1,NV
124,2015,May,62.6,58.3,1396200,1298740,97460,7.0,NV
125,2015,Jun,62.6,58.3,1397085,1301068,96017,6.9,NV
126,2015,Jul,62.5,58.3,1397589,1302948,94641,6.8,NV
127,2015,Aug,62.4,58.2,1398013,1304599,93414,6.7,NV
128,2015,Sep,62.3,58.2,1398568,1306362,92206,6.6,NV
129,2015,Oct,62.3,58.2,1399703,1308661,91042,6.5,NV
130,2015,Nov,62.2,58.2,1401563,1311565,89998,6.4,NV
131,2015,Dec,62.2,58.3,1403650,1314754,88896,6.3,NV
132,2016,Jan,62.2,58.3,1405588,1317857,87731,6.2,NV
133,2016,Feb,62.2,58.4,1407222,1320668,86554,6.2,NV
134,2016,Mar,62.2,58.4,1408473,1323153,85320,6.1,NV
135,2016,Apr,62.1,58.4,1409538,1325445,84093,6.0,NV
136,2016,May,62.1,58.4,1410785,1327774,83011,5.9,NV
137,2016,Jun,62.0,58.4,1412384,1330298,82086,5.8,NV
138,2016,Jul,62.0,58.5,1414241,1333032,81209,5.7,NV
139,2016,Aug,62.0,58.5,1416277,1335898,80379,5.7,NV
140,2016,Sep,62.0,58.5,1418474,1338773,79701,5.6,NV
141,2016,Oct,62.0,58.5,1420709,1341689,79020,5.6,NV
142,2016,Nov,61.9,58.5,1423131,1344990,78141,5.5,NV
143,2016,Dec,62.0,58.6,1426046,1348939,77107,5.4,NV
144,2017,Jan,62.2,58.8,1422626,1345895,76731,5.4,NV
145,2017,Feb,62.3,59.0,1427127,1351001,76126,5.3,NV
146,2017,Mar,62.4,59.1,1431411,1356268,75143,5.2,NV
147,2017,Apr,62.4,59.2,1435347,1361526,73821,5.1,NV
148,2017,May,62.5,59.4,1438906,1366662,72244,5.0,NV
149,2017,Jun,62.6,59.5,1442180,1371436,70744,4.9,NV
150,2017,Jul,62.6,59.6,1445520,1375795,69725,4.8,NV
151,2017,Aug,62.6,59.6,1449012,1379704,69308,4.8,NV
152,2017,Sep,62.7,59.7,1452637,1383214,69423,4.8,NV
153,2017,Oct,62.7,59.7,1456539,1386589,69950,4.8,NV
154,2017,Nov,62.8,59.7,1460795,1390016,70779,4.8,NV
155,2017,Dec,62.9,59.8,1465560,1393994,71566,4.9,NV
156,2018,Jan,63.0,59.9,1470869,1398904,71965,4.9,NV
157,2018,Feb,63.1,60.1,1476446,1404901,71545,4.8,NV
158,2018,Mar,63.2,60.3,1481564,1411555,70009,4.7,NV
159,2018,Apr,63.3,60.4,1485423,1417957,67466,4.5,NV
160,2018,May,63.3,60.6,1487956,1423421,64535,4.3,NV
161,2018,Jun,63.3,60.6,1489801,1427861,61940,4.2,NV
162,2018,Jul,63.2,60.7,1491725,1431447,60278,4.0,NV
163,2018,Aug,63.2,60.7,1494685,1434660,60025,4.0,NV
164,2018,Sep,63.3,60.7,1499101,1437959,61142,4.1,NV
165,2018,Oct,63.4,60.7,1504832,1441672,63160,4.2,NV
166,2018,Nov,63.6,60.8,1511457,1445949,65508,4.3,NV
167,2018,Dec,63.7,60.9,1518368,1450701,67667,4.5,NV
168,2019,Jan,63.9,61.0,1524671,1455672,68999,4.5,NV
169,2019,Feb,64.0,61.1,1529558,1460711,68847,4.5,NV
170,2019,Mar,64.0,61.2,1532659,1465634,67025,4.4,NV
171,2019,Apr,64.0,61.3,1534364,1470507,63857,4.2,NV
172,2019,May,63.9,61.4,1535456,1475161,60295,3.9,NV
173,2019,Jun,63.8,61.5,1536954,1479463,57491,3.7,NV
174,2019,Jul,63.8,61.5,1539584,1483347,56237,3.7,NV
175,2019,Aug,63.9,61.5,1543567,1486905,56662,3.7,NV
176,2019,Sep,64.0,61.6,1548847,1490624,58223,3.8,NV
177,2019,Oct,64.1,61.6,1554200,1494334,59866,3.9,NV
178,2019,Nov,64.1,61.7,1557632,1497511,60121,3.9,NV
179,2019,Dec,64.1,61.6,1558067,1499069,58998,3.8,NV
180,2020,Jan,63.9,61.5,1557061,1498319,58742,3.8,NV
181,2020,Feb,63.8,61.3,1557556,1495176,62380,4.0,NV
182,2020,Mar,63.4,58.4,1549483,1426039,123444,8.0,NV
183,2020,Apr,58.2,41.6,1424442,1018117,406325,28.5,NV
184,2020,May,55.6,42.6,1362621,1043396,319225,23.4,NV
185,2020,Jun,60.6,49.4,1487179,1212146,275033,18.5,NV
186,2020,Jul,61.4,51.1,1509304,1255208,254096,16.8,NV
187,2020,Aug,61.4,52.3,1509581,1287179,222402,14.7,NV
188,2020,Sep,61.8,53.4,1521245,1314409,206836,13.6,NV
189,2020,Oct,61.5,54.1,1516600,1333401,183199,12.1,NV
190,2020,Nov,61.5,54.6,1518249,1347817,170432,11.2,NV
191,2020,Dec,61.6,55.0,1522404,1358304,164100,10.8,NV
192,2021,Jan,61.5,55.2,1521871,1366383,155488,10.2,NV
193,2021,Feb,61.5,55.5,1522506,1373549,148957,9.8,NV
194,2021,Mar,61.4,55.7,1520768,1380648,140120,9.2,NV
195,2021,Apr,61.2,55.9,1517479,1387207,130272,8.6,NV
196,2021,May,60.9,56.1,1511383,1392756,118627,7.8,NV
197,2021,Jun,60.6,56.2,1505986,1397365,108621,7.2,NV
198,2021,Jul,60.2,56.3,1499187,1400892,98295,6.6,NV
199,2021,Aug,59.9,56.3,1494247,1404189,90058,6.0,NV
200,2021,Sep,59.7,56.4,1491008,1407253,83755,5.6,NV
201,2021,Oct,59.6,56.4,1490463,1410441,80022,5.4,NV
202,2021,Nov,59.5,56.4,1491068,1411914,79154,5.3,NV
203,2021,Dec,59.5,56.4,1491740,1412880,78860,5.3,NV
204,2022,Jan,59.5,56.4,1493909,1416858,77051,5.2,NV
205,2022,Feb,59.6,56.6,1498303,1422145,76158,5.1,NV
206,2022,Mar,59.7,56.7,1503210,1427705,75505,5.0,NV
207,2022,Apr,59.9,56.9,1508783,1433224,75559,5.0,NV
208,2022,May,60.1,57.2,1515709,1441560,74149,4.9,NV
209,2022,Jun,60.2,57.4,1519644,1448708,70936,4.7,NV
210,2022,Jul,60.1,57.5,1521130,1453984,67146,4.4,NV
211,2022,Aug,60.3,57.7,1527090,1460626,66464,4.4,NV
212,2022,Sep,60.6,57.9,1536911,1469629,67282,4.4,NV
213,2022,Oct,60.9,58.1,1546700,1475388,71312,4.6,NV
214,2022,Nov,61.1,58.1,1552770,1476576,76194,4.9,NV
0,2005,Jan,65.6,60.9,5069412,4705996,363416,7.2,MI
1,2005,Feb,65.6,61.0,5069092,4708726,360366,7.1,MI
2,2005,Mar,65.6,61.0,5069101,4713415,355686,7.0,MI
3,2005,Apr,65.6,61.1,5069995,4719678,350317,6.9,MI
4,2005,May,65.6,61.1,5071335,4726752,344583,6.8,MI
5,2005,Jun,65.6,61.2,5072040,4732938,339102,6.7,MI
6,2005,Jul,65.6,61.2,5071751,4736805,334946,6.6,MI
7,2005,Aug,65.5,61.2,5070878,4738218,332660,6.6,MI
8,2005,Sep,65.5,61.2,5070043,4737551,332492,6.6,MI
9,2005,Oct,65.4,61.1,5069227,4735206,334021,6.6,MI
10,2005,Nov,65.4,61.0,5068822,4731389,337433,6.7,MI
11,2005,Dec,65.3,60.9,5068366,4726467,341899,6.7,MI
12,2006,Jan,65.3,60.9,5067923,4722032,345891,6.8,MI
13,2006,Feb,65.3,60.8,5067483,4718738,348745,6.9,MI
14,2006,Mar,65.3,60.8,5066385,4715647,350738,6.9,MI
15,2006,Apr,65.3,60.7,5064429,4711722,352707,7.0,MI
16,2006,May,65.2,60.6,5061963,4706902,355061,7.0,MI
17,2006,Jun,65.2,60.6,5058880,4701332,357548,7.1,MI
18,2006,Jul,65.1,60.5,5055515,4696148,359367,7.1,MI
19,2006,Aug,65.1,60.4,5052872,4691989,360883,7.1,MI
20,2006,Sep,65.0,60.4,5050900,4688983,361917,7.2,MI
21,2006,Oct,65.0,60.3,5048765,4687689,361076,7.2,MI
22,2006,Nov,64.9,60.3,5045048,4686860,358188,7.1,MI
23,2006,Dec,64.8,60.3,5038631,4684597,354034,7.0,MI
24,2007,Jan,64.7,60.2,5029796,4679591,350205,7.0,MI
25,2007,Feb,64.6,60.1,5019800,4672378,347422,6.9,MI
26,2007,Mar,64.5,60.0,5009740,4664185,345555,6.9,MI
27,2007,Apr,64.3,59.9,5000964,4656111,344853,6.9,MI
28,2007,May,64.2,59.8,4994572,4648398,346174,6.9,MI
29,2007,Jun,64.2,59.7,4990740,4641105,349635,7.0,MI
30,2007,Jul,64.2,59.6,4988759,4634339,354420,7.1,MI
31,2007,Aug,64.1,59.5,4987655,4628409,359246,7.2,MI
32,2007,Sep,64.1,59.5,4986270,4623665,362605,7.3,MI
33,2007,Oct,64.1,59.4,4983547,4619463,364084,7.3,MI
34,2007,Nov,64.0,59.3,4978443,4615704,362739,7.3,MI
35,2007,Dec,63.9,59.3,4970964,4611446,359518,7.2,MI
36,2008,Jan,63.8,59.2,4962050,4604930,357120,7.2,MI
37,2008,Feb,63.7,59.1,4952602,4595514,357088,7.2,MI
38,2008,Mar,63.6,59.0,4943787,4583166,360621,7.3,MI
39,2008,Apr,63.5,58.8,4936116,4568466,367650,7.4,MI
40,2008,May,63.4,58.6,4929420,4552402,377018,7.6,MI
41,2008,Jun,63.4,58.4,4923379,4535828,387551,7.9,MI
42,2008,Jul,63.3,58.1,4916694,4517863,398831,8.1,MI
43,2008,Aug,63.2,57.9,4908296,4496904,411392,8.4,MI
44,2008,Sep,63.0,57.5,4898438,4471729,426709,8.7,MI
45,2008,Oct,62.9,57.1,4887718,4442055,445663,9.1,MI
46,2008,Nov,62.7,56.7,4876390,4409115,467275,9.6,MI
47,2008,Dec,62.6,56.3,4864371,4375398,488973,10.1,MI
48,2009,Jan,62.7,55.9,4875359,4342294,533065,10.9,MI
49,2009,Feb,62.9,55.5,4885037,4310659,574378,11.8,MI
50,2009,Mar,63.0,55.1,4893566,4282346,611220,12.5,MI
51,2009,Apr,63.1,54.8,4900321,4257967,642354,13.1,MI
52,2009,May,63.1,54.5,4904363,4236418,667945,13.6,MI
53,2009,Jun,63.2,54.3,4905950,4216979,688971,14.0,MI
54,2009,Jul,62.8,54.1,4881546,4199503,682043,14.0,MI
55,2009,Aug,62.5,53.8,4856487,4184303,672184,13.8,MI
56,2009,Sep,62.2,53.7,4832672,4171972,660700,13.7,MI
57,2009,Oct,61.9,53.5,4811810,4162184,649626,13.5,MI
58,2009,Nov,61.7,53.4,4796531,4155159,641372,13.4,MI
59,2009,Dec,61.6,53.4,4788182,4151879,636303,13.3,MI
60,2010,Jan,61.5,53.4,4785142,4153410,631732,13.2,MI
61,2010,Feb,61.5,53.5,4784327,4158820,625507,13.1,MI
62,2010,Mar,61.5,53.6,4783504,4165926,617578,12.9,MI
63,2010,Apr,62.0,54.1,4781950,4173309,608641,12.7,MI
64,2010,May,61.9,54.1,4779667,4179998,599669,12.5,MI
65,2010,Jun,61.9,54.2,4776679,4184137,592542,12.4,MI
66,2010,Jul,61.8,54.2,4773819,4184857,588962,12.3,MI
67,2010,Aug,61.5,54.1,4754004,4183007,570997,12.0,MI
68,2010,Sep,61.3,54.1,4735269,4179731,555538,11.7,MI
69,2010,Oct,61.0,54.0,4717673,4177199,540474,11.5,MI
70,2010,Nov,60.8,54.0,4700743,4176364,524379,11.2,MI
71,2010,Dec,60.5,54.0,4684248,4176837,507411,10.8,MI
72,2011,Jan,60.3,54.0,4669483,4178511,490972,10.5,MI
73,2011,Feb,60.3,54.0,4665113,4180564,484549,10.4,MI
74,2011,Mar,60.0,54.0,4643729,4182090,461639,9.9,MI
75,2011,Apr,60.0,54.0,4649446,4182815,466631,10.0,MI
76,2011,May,60.1,54.0,4655295,4183535,471760,10.1,MI
77,2011,Jun,60.1,54.0,4661368,4186322,475046,10.2,MI
78,2011,Jul,60.2,54.1,4667917,4192853,475064,10.2,MI
79,2011,Aug,60.2,54.2,4674626,4202912,471714,10.1,MI
80,2011,Sep,60.3,54.3,4680596,4215213,465383,9.9,MI
81,2011,Oct,60.3,54.4,4684885,4227863,457022,9.8,MI
82,2011,Nov,60.3,54.6,4686341,4238754,447587,9.6,MI
83,2011,Dec,60.3,54.6,4684886,4246482,438404,9.4,MI
84,2012,Jan,60.2,54.7,4681300,4250546,430754,9.2,MI
85,2012,Feb,60.1,54.7,4677505,4251976,425529,9.1,MI
86,2012,Mar,60.1,54.6,4674978,4251685,423293,9.1,MI
87,2012,Apr,60.0,54.6,4673683,4250642,423041,9.1,MI
88,2012,May,60.0,54.6,4674360,4250834,423526,9.1,MI
89,2012,Jun,60.0,54.6,4676951,4253239,423712,9.1,MI
90,2012,Jul,60.1,54.6,4680759,4257873,422886,9.0,MI
91,2012,Aug,60.1,54.7,4685915,4264274,421641,9.0,MI
92,2012,Sep,60.2,54.8,4692724,4271479,421245,9.0,MI
93,2012,Oct,60.2,54.8,4699999,4278209,421790,9.0,MI
94,2012,Nov,60.3,54.9,4706523,4283628,422895,9.0,MI
95,2012,Dec,60.3,54.9,4711644,4287975,423669,9.0,MI
96,2013,Jan,60.4,54.9,4715747,4292124,423623,9.0,MI
97,2013,Feb,60.4,55.0,4719805,4297093,422712,9.0,MI
98,2013,Mar,60.4,55.1,4724478,4303586,420892,8.9,MI
99,2013,Apr,60.5,55.2,4730864,4311970,418894,8.9,MI
100,2013,May,60.6,55.2,4738195,4320494,417701,8.8,MI
101,2013,Jun,60.6,55.3,4745039,4327389,417650,8.8,MI
102,2013,Jul,60.7,55.3,4749853,4332010,417843,8.8,MI
103,2013,Aug,60.7,55.4,4750495,4334709,415786,8.8,MI
104,2013,Sep,60.6,55.4,4747499,4336984,410515,8.6,MI
105,2013,Oct,60.5,55.4,4744156,4340565,403591,8.5,MI
106,2013,Nov,60.5,55.4,4743413,4346689,396724,8.4,MI
107,2013,Dec,60.5,55.5,4745607,4354920,390687,8.2,MI
108,2014,Jan,60.5,55.6,4749538,4364414,385124,8.1,MI
109,2014,Feb,60.6,55.7,4754121,4374624,379497,8.0,MI
110,2014,Mar,60.6,55.9,4758378,4384836,373542,7.9,MI
111,2014,Apr,60.6,56.0,4760730,4393862,366868,7.7,MI
112,2014,May,60.6,56.0,4760984,4402006,358978,7.5,MI
113,2014,Jun,60.6,56.1,4760581,4410586,349995,7.4,MI
114,2014,Jul,60.6,56.2,4760410,4419845,340565,7.2,MI
115,2014,Aug,60.5,56.3,4761597,4429841,331756,7.0,MI
116,2014,Sep,60.5,56.4,4763243,4439814,323429,6.8,MI
117,2014,Oct,60.5,56.5,4763011,4448646,314365,6.6,MI
118,2014,Nov,60.5,56.6,4759649,4455559,304090,6.4,MI
119,2014,Dec,60.4,56.7,4754985,4461008,293977,6.2,MI
120,2015,Jan,60.3,56.7,4751121,4465483,285638,6.0,MI
121,2015,Feb,60.3,56.8,4748842,4469325,279517,5.9,MI
122,2015,Mar,60.3,56.8,4748857,4473859,274998,5.8,MI
123,2015,Apr,60.3,56.9,4750757,4479763,270994,5.7,MI
124,2015,May,60.3,56.9,4753081,4486713,266368,5.6,MI
125,2015,Jun,60.3,57.0,4754815,4494018,260797,5.5,MI
126,2015,Jul,60.3,57.1,4756256,4501568,254688,5.4,MI
127,2015,Aug,60.3,57.2,4758144,4509543,248601,5.2,MI
128,2015,Sep,60.4,57.3,4761803,4518849,242954,5.1,MI
129,2015,Oct,60.4,57.4,4769314,4530470,238844,5.0,MI
130,2015,Nov,60.5,57.5,4781113,4544206,236907,5.0,MI
131,2015,Dec,60.7,57.7,4795181,4558668,236513,4.9,MI
132,2016,Jan,60.9,57.9,4808822,4571961,236861,4.9,MI
133,2016,Feb,61.0,58.0,4820513,4582714,237799,4.9,MI
134,2016,Mar,61.1,58.1,4829629,4590535,239094,5.0,MI
135,2016,Apr,61.2,58.1,4836910,4596471,240439,5.0,MI
136,2016,May,61.2,58.2,4843434,4601766,241668,5.0,MI
137,2016,Jun,61.3,58.2,4849566,4606797,242769,5.0,MI
138,2016,Jul,61.3,58.2,4855399,4611733,243666,5.0,MI
139,2016,Aug,61.4,58.3,4860940,4616444,244496,5.0,MI
140,2016,Sep,61.4,58.3,4866256,4620323,245933,5.1,MI
141,2016,Oct,61.4,58.3,4870453,4623219,247234,5.1,MI
142,2016,Nov,61.4,58.3,4873086,4626288,246798,5.1,MI
143,2016,Dec,61.4,58.3,4874253,4630737,243516,5.0,MI
144,2017,Jan,61.3,58.4,4896758,4659428,237330,4.8,MI
145,2017,Feb,61.3,58.5,4896252,4668276,227976,4.7,MI
146,2017,Mar,61.3,58.6,4895969,4677098,218871,4.5,MI
147,2017,Apr,61.3,58.6,4897585,4684609,212976,4.3,MI
148,2017,May,61.3,58.7,4902149,4690213,211936,4.3,MI
149,2017,Jun,61.4,58.7,4908978,4693648,215330,4.4,MI
150,2017,Jul,61.4,58.7,4916658,4694847,221811,4.5,MI
151,2017,Aug,61.5,58.6,4922722,4693937,228785,4.6,MI
152,2017,Sep,61.5,58.6,4925268,4691656,233612,4.7,MI
153,2017,Oct,61.5,58.5,4924445,4689603,234842,4.8,MI
154,2017,Nov,61.4,58.5,4921884,4689031,232853,4.7,MI
155,2017,Dec,61.4,58.5,4920031,4691756,228275,4.6,MI
156,2018,Jan,61.4,58.6,4921307,4699003,222304,4.5,MI
157,2018,Feb,61.4,58.7,4926798,4710607,216191,4.4,MI
158,2018,Mar,61.5,58.9,4934424,4724083,210341,4.3,MI
159,2018,Apr,61.6,59.0,4940110,4735329,204781,4.1,MI
160,2018,May,61.6,59.1,4942048,4741589,200459,4.1,MI
161,2018,Jun,61.6,59.1,4941326,4742855,198471,4.0,MI
162,2018,Jul,61.5,59.0,4939428,4740742,198686,4.0,MI
163,2018,Aug,61.5,59.0,4938929,4738274,200655,4.1,MI
164,2018,Sep,61.5,59.0,4941061,4737567,203494,4.1,MI
165,2018,Oct,61.5,59.0,4945622,4739280,206342,4.2,MI
166,2018,Nov,61.6,59.0,4951727,4743011,208716,4.2,MI
167,2018,Dec,61.7,59.0,4957789,4747929,209860,4.2,MI
168,2019,Jan,61.7,59.1,4962244,4752990,209254,4.2,MI
169,2019,Feb,61.7,59.2,4964805,4757683,207122,4.2,MI
170,2019,Mar,61.8,59.2,4966873,4761695,205178,4.1,MI
171,2019,Apr,61.8,59.2,4969895,4765306,204589,4.1,MI
172,2019,May,61.8,59.3,4973009,4767742,205267,4.1,MI
173,2019,Jun,61.8,59.3,4975206,4768486,206720,4.2,MI
174,2019,Jul,61.8,59.2,4975972,4767901,208071,4.2,MI
175,2019,Aug,61.8,59.2,4975210,4767057,208153,4.2,MI
176,2019,Sep,61.7,59.2,4973743,4768528,205215,4.1,MI
177,2019,Oct,61.7,59.2,4971894,4772044,199850,4.0,MI
178,2019,Nov,61.7,59.2,4968361,4774614,193747,3.9,MI
179,2019,Dec,61.5,59.2,4960659,4771296,189363,3.8,MI
180,2020,Jan,61.4,59.0,4947228,4759231,187997,3.8,MI
181,2020,Feb,61.1,58.8,4926425,4738902,187523,3.8,MI
182,2020,Mar,60.8,58.5,4899311,4715188,184123,3.8,MI
183,2020,Apr,56.6,43.7,4560551,3524836,1035715,22.7,MI
184,2020,May,60.5,48.9,4873862,3937789,936073,19.2,MI
185,2020,Jun,62.0,52.9,4992980,4266100,726880,14.6,MI
186,2020,Jul,61.3,53.6,4934852,4315434,619418,12.6,MI
187,2020,Aug,60.3,54.3,4861442,4377730,483712,9.9,MI
188,2020,Sep,60.1,54.9,4844405,4421486,422919,8.7,MI
189,2020,Oct,59.6,55.1,4802783,4441635,361148,7.5,MI
190,2020,Nov,59.4,55.2,4786854,4448752,338102,7.1,MI
191,2020,Dec,58.3,54.2,4695972,4369522,326450,7.0,MI
192,2021,Jan,59.0,55.2,4755919,4449362,306557,6.4,MI
193,2021,Feb,59.0,55.2,4751610,4451853,299757,6.3,MI
194,2021,Mar,59.0,55.3,4753677,4457749,295928,6.2,MI
195,2021,Apr,59.1,55.4,4762840,4465367,297473,6.2,MI
196,2021,May,59.2,55.5,4771544,4473656,297888,6.2,MI
197,2021,Jun,59.4,55.6,4784578,4481616,302962,6.3,MI
198,2021,Jul,59.4,55.7,4791068,4492147,298921,6.2,MI
199,2021,Aug,59.4,55.9,4793832,4505360,288472,6.0,MI
200,2021,Sep,59.4,56.0,4792660,4521171,271489,5.7,MI
201,2021,Oct,59.4,56.2,4791888,4535422,256466,5.4,MI
202,2021,Nov,59.3,56.2,4789198,4541141,248057,5.2,MI
203,2021,Dec,59.3,56.3,4788181,4542717,245464,5.1,MI
204,2022,Jan,59.4,56.5,4795131,4561559,233572,4.9,MI
205,2022,Feb,59.5,56.7,4804242,4576270,227972,4.7,MI
206,2022,Mar,59.6,57.0,4818938,4604587,214351,4.4,MI
207,2022,Apr,59.8,57.2,4833339,4624362,208977,4.3,MI
208,2022,May,60.0,57.4,4849573,4642332,207241,4.3,MI
209,2022,Jun,60.1,57.5,4856074,4648902,207172,4.3,MI
210,2022,Jul,60.1,57.6,4859310,4657180,202130,4.2,MI
211,2022,Aug,60.1,57.6,4858848,4658168,200680,4.1,MI
212,2022,Sep,60.1,57.6,4860950,4660152,200798,4.1,MI
213,2022,Oct,60.0,57.4,4854759,4649634,205125,4.2,MI
214,2022,Nov,59.9,57.4,4852915,4644885,208030,4.3,MI
0,2005,Jan,68.9,65.9,718063,686859,31204,4.3,ID
1,2005,Feb,69.0,66.1,720965,690455,30510,4.2,ID
2,2005,Mar,69.1,66.2,723846,693803,30043,4.2,ID
3,2005,Apr,69.2,66.4,726623,696833,29790,4.1,ID
4,2005,May,69.3,66.5,729260,699591,29669,4.1,ID
5,2005,Jun,69.4,66.6,731642,702030,29612,4.0,ID
6,2005,Jul,69.4,66.6,733547,704126,29421,4.0,ID
7,2005,Aug,69.4,66.6,734841,705881,28960,3.9,ID
8,2005,Sep,69.3,66.6,735658,707285,28373,3.9,ID
9,2005,Oct,69.1,66.5,736264,708439,27825,3.8,ID
10,2005,Nov,69.0,66.4,736969,709484,27485,3.7,ID
11,2005,Dec,68.9,66.4,737865,710506,27359,3.7,ID
12,2006,Jan,68.8,66.3,738902,711591,27311,3.7,ID
13,2006,Feb,68.8,66.3,739890,712681,27209,3.7,ID
14,2006,Mar,68.7,66.2,740751,713742,27009,3.6,ID
15,2006,Apr,68.6,66.2,741494,714784,26710,3.6,ID
16,2006,May,68.5,66.1,742127,715861,26266,3.5,ID
17,2006,Jun,68.4,66.1,742774,717041,25733,3.5,ID
18,2006,Jul,68.4,66.1,743753,718495,25258,3.4,ID
19,2006,Aug,68.4,66.1,745184,720255,24929,3.3,ID
20,2006,Sep,68.4,66.1,746840,722205,24635,3.3,ID
21,2006,Oct,68.4,66.2,748469,724217,24252,3.2,ID
22,2006,Nov,68.4,66.2,749884,726133,23751,3.2,ID
23,2006,Dec,68.3,66.2,750946,727798,23148,3.1,ID
24,2007,Jan,68.3,66.2,751704,729172,22532,3.0,ID
25,2007,Feb,68.2,66.2,752358,730389,21969,2.9,ID
26,2007,Mar,68.1,66.2,752994,731466,21528,2.9,ID
27,2007,Apr,68.1,66.2,753743,732433,21310,2.8,ID
28,2007,May,68.0,66.1,754736,733266,21470,2.8,ID
29,2007,Jun,68.0,66.0,755825,733862,21963,2.9,ID
30,2007,Jul,67.9,65.9,756838,734072,22766,3.0,ID
31,2007,Aug,67.9,65.8,757610,733890,23720,3.1,ID
32,2007,Sep,67.8,65.6,757879,733406,24473,3.2,ID
33,2007,Oct,67.7,65.4,757432,732664,24768,3.3,ID
34,2007,Nov,67.4,65.2,756280,731723,24557,3.2,ID
35,2007,Dec,67.2,65.0,754691,730659,24032,3.2,ID
36,2008,Jan,66.9,64.8,753003,729462,23541,3.1,ID
37,2008,Feb,66.7,64.6,751556,728191,23365,3.1,ID
38,2008,Mar,66.5,64.4,750634,726940,23694,3.2,ID
39,2008,Apr,67.0,64.2,756944,725740,31204,4.1,ID
40,2008,May,67.2,64.0,760351,724589,35762,4.7,ID
41,2008,Jun,67.2,63.8,762381,723505,38876,5.1,ID
42,2008,Jul,67.2,63.6,763509,722338,41171,5.4,ID
43,2008,Aug,67.2,63.4,763961,720883,43078,5.6,ID
44,2008,Sep,67.1,63.2,764150,718961,45189,5.9,ID
45,2008,Oct,67.1,62.9,764450,716492,47958,6.3,ID
46,2008,Nov,67.0,62.5,764784,713504,51280,6.7,ID
47,2008,Dec,67.0,62.2,764905,710176,54729,7.2,ID
48,2009,Jan,66.9,61.8,764671,706733,57938,7.6,ID
49,2009,Feb,66.8,61.5,764044,703500,60544,7.9,ID
50,2009,Mar,66.6,61.2,763045,700851,62194,8.2,ID
51,2009,Apr,66.4,60.9,761716,698919,62797,8.2,ID
52,2009,May,66.7,60.8,765242,697495,67747,8.9,ID
53,2009,Jun,66.6,60.6,765973,696379,69594,9.1,ID
54,2009,Jul,66.5,60.4,765397,695387,70010,9.1,ID
55,2009,Aug,66.4,60.3,764334,694403,69931,9.1,ID
56,2009,Sep,66.2,60.1,763191,693446,69745,9.1,ID
57,2009,Oct,66.0,60.0,762147,692584,69563,9.1,ID
58,2009,Nov,65.9,59.9,761632,692099,69533,9.1,ID
59,2009,Dec,65.9,59.9,761927,692251,69676,9.1,ID
60,2010,Jan,65.9,59.9,762726,693074,69652,9.1,ID
61,2010,Feb,65.9,59.9,763525,694203,69322,9.1,ID
62,2010,Mar,65.9,60.0,763983,695240,68743,9.0,ID
63,2010,Apr,65.7,59.8,764012,696013,67999,8.9,ID
64,2010,May,65.6,59.8,763624,696473,67151,8.8,ID
65,2010,Jun,65.5,59.8,762884,696497,66387,8.7,ID
66,2010,Jul,65.3,59.7,761967,696118,65849,8.6,ID
67,2010,Aug,65.2,59.6,761137,695586,65551,8.6,ID
68,2010,Sep,65.1,59.5,760571,695155,65416,8.6,ID
69,2010,Oct,65.0,59.4,760364,695058,65306,8.6,ID
70,2010,Nov,64.9,59.4,760441,695300,65141,8.6,ID
71,2010,Dec,64.9,59.4,760670,695790,64880,8.5,ID
72,2011,Jan,64.9,59.4,761044,696460,64584,8.5,ID
73,2011,Feb,64.9,59.4,761435,697172,64263,8.4,ID
74,2011,Mar,64.8,59.4,761692,697768,63924,8.4,ID
75,2011,Apr,64.8,59.4,761780,698168,63612,8.4,ID
76,2011,May,64.7,59.3,761901,698553,63348,8.3,ID
77,2011,Jun,64.7,59.3,762271,699223,63048,8.3,ID
78,2011,Jul,64.7,59.4,763074,700436,62638,8.2,ID
79,2011,Aug,64.7,59.5,764301,702187,62114,8.1,ID
80,2011,Sep,64.8,59.6,765783,704282,61501,8.0,ID
81,2011,Oct,64.8,59.7,767335,706484,60851,7.9,ID
82,2011,Nov,64.9,59.8,768639,708451,60188,7.8,ID
83,2011,Dec,64.9,59.9,769548,709965,59583,7.7,ID
84,2012,Jan,64.9,59.9,770197,711077,59120,7.7,ID
85,2012,Feb,64.9,59.9,770719,711923,58796,7.6,ID
86,2012,Mar,64.9,59.9,771103,712536,58567,7.6,ID
87,2012,Apr,64.8,59.9,771346,713010,58336,7.6,ID
88,2012,May,64.8,59.9,771563,713524,58039,7.5,ID
89,2012,Jun,64.7,59.9,771845,714218,57627,7.5,ID
90,2012,Jul,64.7,59.9,772210,715144,57066,7.4,ID
91,2012,Aug,64.7,59.9,772638,716202,56436,7.3,ID
92,2012,Sep,64.6,60.0,773091,717238,55853,7.2,ID
93,2012,Oct,64.6,59.9,773385,718040,55345,7.2,ID
94,2012,Nov,64.5,59.9,773460,718524,54936,7.1,ID
95,2012,Dec,64.4,59.9,773323,718703,54620,7.1,ID
96,2013,Jan,64.3,59.8,773064,718684,54380,7.0,ID
97,2013,Feb,64.3,59.8,773031,718812,54219,7.0,ID
98,2013,Mar,64.3,59.8,773507,719407,54100,7.0,ID
99,2013,Apr,64.3,59.8,774575,720581,53994,7.0,ID
100,2013,May,64.3,59.9,776008,722073,53935,7.0,ID
101,2013,Jun,64.4,59.9,777564,723613,53951,6.9,ID
102,2013,Jul,64.4,60.0,779087,725099,53988,6.9,ID
103,2013,Aug,64.5,60.0,780447,726569,53878,6.9,ID
104,2013,Sep,64.5,60.1,781625,728067,53558,6.9,ID
105,2013,Oct,64.5,60.1,782755,729577,53178,6.8,ID
106,2013,Nov,64.3,60.2,781042,731179,49863,6.4,ID
107,2013,Dec,64.1,60.2,779488,732868,46620,6.0,ID
108,2014,Jan,63.9,60.3,778076,734548,43528,5.6,ID
109,2014,Feb,63.7,60.4,776745,736121,40624,5.2,ID
110,2014,Mar,63.5,60.4,775559,737567,37992,4.9,ID
111,2014,Apr,63.4,60.4,774476,738865,35611,4.6,ID
112,2014,May,63.3,60.5,774878,740193,34685,4.5,ID
113,2014,Jun,63.0,60.5,772518,741711,30807,4.0,ID
114,2014,Jul,63.1,60.6,774415,743273,31142,4.0,ID
115,2014,Aug,63.2,60.6,776184,744890,31294,4.0,ID
116,2014,Sep,63.2,60.7,777919,746662,31257,4.0,ID
117,2014,Oct,63.3,60.8,779643,748640,31003,4.0,ID
118,2014,Nov,63.3,60.8,781294,750676,30618,3.9,ID
119,2014,Dec,63.4,60.9,783031,752712,30319,3.9,ID
120,2015,Jan,63.5,61.0,785010,754789,30221,3.8,ID
121,2015,Feb,63.6,61.1,787221,756853,30368,3.9,ID
122,2015,Mar,63.7,61.2,789517,758877,30640,3.9,ID
123,2015,Apr,63.8,61.3,791724,760809,30915,3.9,ID
124,2015,May,63.9,61.4,793675,762546,31129,3.9,ID
125,2015,Jun,63.9,61.4,795165,763973,31192,3.9,ID
126,2015,Jul,63.9,61.4,796345,765212,31133,3.9,ID
127,2015,Aug,63.9,61.4,797404,766369,31035,3.9,ID
128,2015,Sep,63.8,61.3,798413,767529,30884,3.9,ID
129,2015,Oct,63.8,61.3,799645,768912,30733,3.8,ID
130,2015,Nov,63.8,61.4,801327,770672,30655,3.8,ID
131,2015,Dec,63.8,61.4,803322,772741,30581,3.8,ID
132,2016,Jan,63.9,61.5,805322,774854,30468,3.8,ID
133,2016,Feb,63.9,61.5,807148,776822,30326,3.8,ID
134,2016,Mar,63.9,61.5,808719,778561,30158,3.7,ID
135,2016,Apr,63.9,61.5,810104,780076,30028,3.7,ID
136,2016,May,63.9,61.5,811416,781429,29987,3.7,ID
137,2016,Jun,63.9,61.5,812750,782732,30018,3.7,ID
138,2016,Jul,63.8,61.5,814013,784003,30010,3.7,ID
139,2016,Aug,63.8,61.4,815143,785242,29901,3.7,ID
140,2016,Sep,63.7,61.4,816266,786512,29754,3.6,ID
141,2016,Oct,63.7,61.4,817413,787865,29548,3.6,ID
142,2016,Nov,63.7,61.4,818658,789438,29220,3.6,ID
143,2016,Dec,63.6,61.4,820142,791352,28790,3.5,ID
144,2017,Jan,63.6,61.4,826911,798308,28603,3.5,ID
145,2017,Feb,63.7,61.5,829087,801101,27986,3.4,ID
146,2017,Mar,63.7,61.6,831417,804009,27408,3.3,ID
147,2017,Apr,63.8,61.7,833850,806935,26915,3.2,ID
148,2017,May,63.8,61.8,836335,809789,26546,3.2,ID
149,2017,Jun,63.9,61.9,838842,812467,26375,3.1,ID
150,2017,Jul,63.9,61.9,841394,814980,26414,3.1,ID
151,2017,Aug,64.0,62.0,843855,817266,26589,3.2,ID
152,2017,Sep,64.0,62.0,845994,819239,26755,3.2,ID
153,2017,Oct,64.0,62.0,847754,821014,26740,3.2,ID
154,2017,Nov,64.0,62.0,849162,822645,26517,3.1,ID
155,2017,Dec,64.0,62.0,850457,824364,26093,3.1,ID
156,2018,Jan,64.0,62.1,851950,826388,25562,3.0,ID
157,2018,Feb,64.0,62.1,853941,828889,25052,2.9,ID
158,2018,Mar,64.1,62.2,856347,831700,24647,2.9,ID
159,2018,Apr,64.1,62.3,858709,834330,24379,2.8,ID
160,2018,May,64.2,62.3,860704,836410,24294,2.8,ID
161,2018,Jun,64.1,62.3,862277,837905,24372,2.8,ID
162,2018,Jul,64.1,62.3,863502,838950,24552,2.8,ID
163,2018,Aug,64.0,62.2,864741,839887,24854,2.9,ID
164,2018,Sep,64.0,62.1,866283,840994,25289,2.9,ID
165,2018,Oct,64.0,62.1,868218,842436,25782,3.0,ID
166,2018,Nov,64.0,62.1,870533,844339,26194,3.0,ID
167,2018,Dec,64.1,62.1,873063,846680,26383,3.0,ID
168,2019,Jan,64.1,62.2,875553,849257,26296,3.0,ID
169,2019,Feb,64.2,62.3,877903,851930,25973,3.0,ID
170,2019,Mar,64.2,62.4,880234,854604,25630,2.9,ID
171,2019,Apr,64.3,62.4,882774,857322,25452,2.9,ID
172,2019,May,64.3,62.5,885515,859979,25536,2.9,ID
173,2019,Jun,64.4,62.5,888376,862471,25905,2.9,ID
174,2019,Jul,64.5,62.5,891194,864721,26473,3.0,ID
175,2019,Aug,64.5,62.5,893779,866785,26994,3.0,ID
176,2019,Sep,64.5,62.5,896149,868987,27162,3.0,ID
177,2019,Oct,64.5,62.6,898358,871285,27073,3.0,ID
178,2019,Nov,64.5,62.6,900239,873409,26830,3.0,ID
179,2019,Dec,64.4,62.5,901369,874746,26623,3.0,ID
180,2020,Jan,64.3,62.4,901645,874970,26675,3.0,ID
181,2020,Feb,64.1,62.2,901103,874104,26999,3.0,ID
182,2020,Mar,63.8,62.0,898287,872787,25500,2.8,ID
183,2020,Apr,62.6,55.2,883664,779191,104473,11.8,ID
184,2020,May,63.1,57.5,892862,813394,79468,8.9,ID
185,2020,Jun,62.9,58.3,890942,826239,64703,7.3,ID
186,2020,Jul,63.0,59.0,894847,838434,56413,6.3,ID
187,2020,Aug,62.9,59.6,895576,848465,47111,5.3,ID
188,2020,Sep,63.0,60.0,900182,856718,43464,4.8,ID
189,2020,Oct,62.9,60.2,901471,862354,39117,4.3,ID
190,2020,Nov,62.9,60.3,903867,866139,37728,4.2,ID
191,2020,Dec,62.9,60.3,906483,868813,37670,4.2,ID
192,2021,Jan,62.9,60.3,907948,871201,36747,4.0,ID
193,2021,Feb,62.9,60.3,910009,873702,36307,4.0,ID
194,2021,Mar,62.8,60.4,912023,876422,35601,3.9,ID
195,2021,Apr,62.8,60.4,914122,879079,35043,3.8,ID
196,2021,May,62.7,60.4,915795,881489,34306,3.7,ID
197,2021,Jun,62.7,60.4,917529,883514,34015,3.7,ID
198,2021,Jul,62.6,60.3,918907,885623,33284,3.6,ID
199,2021,Aug,62.5,60.3,920046,887733,32313,3.5,ID
200,2021,Sep,62.3,60.2,920969,890000,30969,3.4,ID
201,2021,Oct,62.2,60.2,921775,892027,29748,3.2,ID
202,2021,Nov,62.0,60.1,921829,892721,29108,3.2,ID
203,2021,Dec,61.8,59.9,921726,892861,28865,3.1,ID
204,2022,Jan,61.8,60.0,924378,896968,27410,3.0,ID
205,2022,Feb,61.8,60.1,927196,901070,26126,2.8,ID
206,2022,Mar,62.0,60.4,932253,907544,24709,2.7,ID
207,2022,Apr,62.1,60.5,937017,912962,24055,2.6,ID
208,2022,May,62.4,60.8,943386,919798,23588,2.5,ID
209,2022,Jun,62.5,61.0,948562,924610,23952,2.5,ID
210,2022,Jul,62.6,61.0,952401,927974,24427,2.6,ID
211,2022,Aug,62.7,61.0,956796,931099,25697,2.7,ID
212,2022,Sep,62.7,60.9,959727,932813,26914,2.8,ID
213,2022,Oct,62.6,60.8,961450,933282,28168,2.9,ID
214,2022,Nov,62.5,60.7,963380,934756,28624,3.0,ID
0,2005,Jan,65.2,63.2,617673,598918,18755,3.0,HI
1,2005,Feb,65.3,63.3,618846,600440,18406,3.0,HI
2,2005,Mar,65.4,63.5,620188,602193,17995,2.9,HI
3,2005,Apr,65.5,63.6,621790,604188,17602,2.8,HI
4,2005,May,65.7,63.8,623721,606410,17311,2.8,HI
5,2005,Jun,65.8,64.0,625770,608578,17192,2.7,HI
6,2005,Jul,66.0,64.2,627667,610383,17284,2.8,HI
7,2005,Aug,66.1,64.3,629176,611695,17481,2.8,HI
8,2005,Sep,66.2,64.3,630132,612523,17609,2.8,HI
9,2005,Oct,66.1,64.2,630555,612996,17559,2.8,HI
10,2005,Nov,66.0,64.2,630663,613292,17371,2.8,HI
11,2005,Dec,65.9,64.1,630664,613526,17138,2.7,HI
12,2006,Jan,65.9,64.1,630827,613850,16977,2.7,HI
13,2006,Feb,65.9,64.1,631267,614296,16971,2.7,HI
14,2006,Mar,65.9,64.1,631983,614874,17109,2.7,HI
15,2006,Apr,66.0,64.2,632898,615623,17275,2.7,HI
16,2006,May,66.1,64.3,633852,616564,17288,2.7,HI
17,2006,Jun,66.1,64.3,634758,617722,17036,2.7,HI
18,2006,Jul,66.2,64.5,635731,619244,16487,2.6,HI
19,2006,Aug,66.2,64.6,636833,621045,15788,2.5,HI
20,2006,Sep,66.3,64.7,637954,622790,15164,2.4,HI
21,2006,Oct,66.4,64.8,638975,624209,14766,2.3,HI
22,2006,Nov,66.4,64.9,639733,625059,14674,2.3,HI
23,2006,Dec,66.4,64.8,640049,625186,14863,2.3,HI
24,2007,Jan,66.3,64.7,639907,624680,15227,2.4,HI
25,2007,Feb,66.2,64.6,639382,623747,15635,2.4,HI
26,2007,Mar,66.1,64.4,638441,622449,15992,2.5,HI
27,2007,Apr,65.9,64.2,637218,620930,16288,2.6,HI
28,2007,May,65.7,64.0,635993,619428,16565,2.6,HI
29,2007,Jun,65.6,63.9,634988,618131,16857,2.7,HI
30,2007,Jul,65.5,63.7,634347,617083,17264,2.7,HI
31,2007,Aug,65.4,63.6,634307,616467,17840,2.8,HI
32,2007,Sep,65.5,63.6,634954,616466,18488,2.9,HI
33,2007,Oct,65.5,63.6,636095,617035,19060,3.0,HI
34,2007,Nov,65.6,63.6,637526,618088,19438,3.0,HI
35,2007,Dec,65.8,63.7,639094,619435,19659,3.1,HI
36,2008,Jan,65.9,63.8,640525,620658,19867,3.1,HI
37,2008,Feb,66.0,63.9,641682,621470,20212,3.1,HI
38,2008,Mar,66.0,63.9,642622,621796,20826,3.2,HI
39,2008,Apr,66.1,63.8,643304,621515,21789,3.4,HI
40,2008,May,66.1,63.7,643618,620551,23067,3.6,HI
41,2008,Jun,66.0,63.5,643567,619036,24531,3.8,HI
42,2008,Jul,65.9,63.3,643139,617129,26010,4.0,HI
43,2008,Aug,65.8,63.0,642316,614884,27432,4.3,HI
44,2008,Sep,65.7,62.7,641210,612280,28930,4.5,HI
45,2008,Oct,65.5,62.3,639971,609289,30682,4.8,HI
46,2008,Nov,65.3,62.0,638587,605845,32742,5.1,HI
47,2008,Dec,65.1,61.5,637096,602094,35002,5.5,HI
48,2009,Jan,64.9,61.1,635569,598286,37283,5.9,HI
49,2009,Feb,64.7,60.7,634151,594807,39344,6.2,HI
50,2009,Mar,64.6,60.4,633015,592076,40939,6.5,HI
51,2009,Apr,64.5,60.2,632282,590308,41974,6.6,HI
52,2009,May,64.4,60.1,631952,589386,42566,6.7,HI
53,2009,Jun,64.4,60.0,631868,588993,42875,6.8,HI
54,2009,Jul,64.3,60.0,631704,588669,43035,6.8,HI
55,2009,Aug,64.3,59.9,631317,588153,43164,6.8,HI
56,2009,Sep,64.2,59.8,630905,587593,43312,6.9,HI
57,2009,Oct,64.1,59.7,630679,587205,43474,6.9,HI
58,2009,Nov,64.1,59.7,631046,587373,43673,6.9,HI
59,2009,Dec,64.2,59.8,632327,588446,43881,6.9,HI
60,2010,Jan,64.4,59.9,634566,590573,43993,6.9,HI
61,2010,Feb,64.7,60.2,637461,593468,43993,6.9,HI
62,2010,Mar,65.0,60.5,640630,596671,43959,6.9,HI
63,2010,Apr,61.9,57.7,643754,599835,43919,6.8,HI
64,2010,May,62.1,57.9,646474,602624,43850,6.8,HI
65,2010,Jun,62.2,58.0,648687,604821,43866,6.8,HI
66,2010,Jul,62.3,58.1,650583,606535,44048,6.8,HI
67,2010,Aug,62.4,58.2,652315,607978,44337,6.8,HI
68,2010,Sep,62.5,58.2,653928,609279,44649,6.8,HI
69,2010,Oct,62.6,58.3,655653,610770,44883,6.8,HI
70,2010,Nov,62.7,58.4,657494,612571,44923,6.8,HI
71,2010,Dec,62.8,58.5,659209,614428,44781,6.8,HI
72,2011,Jan,62.9,58.6,660636,616041,44595,6.8,HI
73,2011,Feb,62.9,58.7,661609,617144,44465,6.7,HI
74,2011,Mar,62.9,58.7,662006,617560,44446,6.7,HI
75,2011,Apr,62.8,58.6,661862,617235,44627,6.7,HI
76,2011,May,62.8,58.5,661495,616453,45042,6.8,HI
77,2011,Jun,62.7,58.3,661170,615617,45553,6.9,HI
78,2011,Jul,62.6,58.2,660995,615010,45985,7.0,HI
79,2011,Aug,62.5,58.1,660874,614669,46205,7.0,HI
80,2011,Sep,62.4,58.1,660501,614430,46071,7.0,HI
81,2011,Oct,62.3,58.0,659648,614041,45607,6.9,HI
82,2011,Nov,62.1,57.8,658261,613338,44923,6.8,HI
83,2011,Dec,61.9,57.7,656523,612414,44109,6.7,HI
84,2012,Jan,61.7,57.6,654711,611452,43259,6.6,HI
85,2012,Feb,61.5,57.5,653076,610580,42496,6.5,HI
86,2012,Mar,61.3,57.4,651755,609893,41862,6.4,HI
87,2012,Apr,61.2,57.3,650783,609546,41237,6.3,HI
88,2012,May,61.1,57.3,650165,609679,40486,6.2,HI
89,2012,Jun,61.0,57.3,649786,610269,39517,6.1,HI
90,2012,Jul,60.9,57.3,649583,611262,38321,5.9,HI
91,2012,Aug,60.9,57.4,649534,612513,37021,5.7,HI
92,2012,Sep,60.9,57.5,649620,613823,35797,5.5,HI
93,2012,Oct,60.8,57.6,649565,614838,34727,5.3,HI
94,2012,Nov,60.7,57.6,649173,615327,33846,5.2,HI
95,2012,Dec,60.6,57.5,648487,615337,33150,5.1,HI
96,2013,Jan,60.5,57.4,647730,615167,32563,5.0,HI
97,2013,Feb,60.4,57.4,647257,615252,32005,4.9,HI
98,2013,Mar,60.4,57.4,647266,615831,31435,4.9,HI
99,2013,Apr,60.4,57.5,647794,616903,30891,4.8,HI
100,2013,May,60.4,57.6,648702,618211,30491,4.7,HI
101,2013,Jun,60.5,57.7,649806,619477,30329,4.7,HI
102,2013,Jul,60.6,57.8,650974,620569,30405,4.7,HI
103,2013,Aug,60.6,57.8,652138,621567,30571,4.7,HI
104,2013,Sep,60.7,57.9,653325,622633,30692,4.7,HI
105,2013,Oct,60.8,58.0,654646,623909,30737,4.7,HI
106,2013,Nov,61.0,58.1,656212,625532,30680,4.7,HI
107,2013,Dec,61.1,58.2,657879,627380,30499,4.6,HI
108,2014,Jan,61.2,58.4,659402,629214,30188,4.6,HI
109,2014,Feb,61.3,58.5,660678,630881,29797,4.5,HI
110,2014,Mar,61.4,58.6,661775,632329,29446,4.4,HI
111,2014,Apr,61.4,58.7,662692,633518,29174,4.4,HI
112,2014,May,61.5,58.8,663424,634545,28879,4.4,HI
113,2014,Jun,61.5,58.9,664120,635619,28501,4.3,HI
114,2014,Jul,61.5,58.9,664779,636723,28056,4.2,HI
115,2014,Aug,61.6,59.0,665410,637809,27601,4.1,HI
116,2014,Sep,61.6,59.1,666039,638866,27173,4.1,HI
117,2014,Oct,61.6,59.1,666609,639868,26741,4.0,HI
118,2014,Nov,61.6,59.2,667024,640728,26296,3.9,HI
119,2014,Dec,61.6,59.2,667398,641508,25890,3.9,HI
120,2015,Jan,61.6,59.3,667875,642329,25546,3.8,HI
121,2015,Feb,61.6,59.3,668343,643165,25178,3.8,HI
122,2015,Mar,61.7,59.4,668758,644078,24680,3.7,HI
123,2015,Apr,61.7,59.5,669187,645104,24083,3.6,HI
124,2015,May,61.7,59.5,669614,646142,23472,3.5,HI
125,2015,Jun,61.7,59.6,669943,647039,22904,3.4,HI
126,2015,Jul,61.7,59.6,670277,647849,22428,3.3,HI
127,2015,Aug,61.7,59.7,670776,648736,22040,3.3,HI
128,2015,Sep,61.7,59.7,671504,649824,21680,3.2,HI
129,2015,Oct,61.8,59.8,672548,651209,21339,3.2,HI
130,2015,Nov,61.8,59.9,673778,652737,21041,3.1,HI
131,2015,Dec,61.9,60.0,674900,654135,20765,3.1,HI
132,2016,Jan,61.9,60.0,675700,655187,20513,3.0,HI
133,2016,Feb,61.9,60.1,676234,655874,20360,3.0,HI
134,2016,Mar,62.0,60.1,676608,656314,20294,3.0,HI
135,2016,Apr,62.0,60.1,676978,656743,20235,3.0,HI
136,2016,May,62.0,60.2,677630,657476,20154,3.0,HI
137,2016,Jun,62.1,60.2,678662,658647,20015,2.9,HI
138,2016,Jul,62.1,60.3,679858,660086,19772,2.9,HI
139,2016,Aug,62.2,60.4,680909,661451,19458,2.9,HI
140,2016,Sep,62.3,60.5,681639,662483,19156,2.8,HI
141,2016,Oct,62.3,60.6,681999,663144,18855,2.8,HI
142,2016,Nov,62.3,60.6,682195,663687,18508,2.7,HI
143,2016,Dec,62.3,60.7,682432,664308,18124,2.7,HI
144,2017,Jan,62.3,60.7,697290,679241,18049,2.6,HI
145,2017,Feb,62.3,60.8,698076,680263,17813,2.6,HI
146,2017,Mar,62.4,60.8,698739,681195,17544,2.5,HI
147,2017,Apr,62.4,60.9,699003,681836,17167,2.5,HI
148,2017,May,62.4,60.9,698628,682060,16568,2.4,HI
149,2017,Jun,62.3,60.8,697513,681765,15748,2.3,HI
150,2017,Jul,62.1,60.8,695816,681002,14814,2.1,HI
151,2017,Aug,61.9,60.6,693848,679954,13894,2.0,HI
152,2017,Sep,61.7,60.5,691983,678813,13170,1.9,HI
153,2017,Oct,61.5,60.4,690640,677815,12825,1.9,HI
154,2017,Nov,61.5,60.3,690058,677106,12952,1.9,HI
155,2017,Dec,61.5,60.3,690394,676938,13456,1.9,HI
156,2018,Jan,61.6,60.3,691605,677395,14210,2.1,HI
157,2018,Feb,61.7,60.4,693399,678324,15075,2.2,HI
158,2018,Mar,61.9,60.5,695255,679371,15884,2.3,HI
159,2018,Apr,62.0,60.5,696488,680023,16465,2.4,HI
160,2018,May,62.0,60.5,696557,679818,16739,2.4,HI
161,2018,Jun,61.9,60.4,695460,678739,16721,2.4,HI
162,2018,Jul,61.7,60.2,693476,677020,16456,2.4,HI
163,2018,Aug,61.5,60.0,691084,674938,16146,2.3,HI
164,2018,Sep,61.2,59.8,688755,672742,16013,2.3,HI
165,2018,Oct,61.1,59.6,686908,670692,16216,2.4,HI
166,2018,Nov,61.0,59.5,685747,668938,16809,2.5,HI
167,2018,Dec,60.9,59.3,685240,667556,17684,2.6,HI
168,2019,Jan,60.9,59.3,685158,666547,18611,2.7,HI
169,2019,Feb,60.9,59.2,685255,665919,19336,2.8,HI
170,2019,Mar,61.0,59.2,685374,665629,19745,2.9,HI
171,2019,Apr,61.0,59.2,685423,665713,19710,2.9,HI
172,2019,May,61.0,59.3,685361,666208,19153,2.8,HI
173,2019,Jun,61.0,59.3,685149,667023,18126,2.6,HI
174,2019,Jul,60.9,59.4,684632,667894,16738,2.4,HI
175,2019,Aug,60.8,59.5,683925,668718,15207,2.2,HI
176,2019,Sep,60.8,59.6,683497,669649,13848,2.0,HI
177,2019,Oct,60.8,59.6,683631,670591,13040,1.9,HI
178,2019,Nov,60.8,59.7,684365,671426,12939,1.9,HI
179,2019,Dec,60.9,59.7,685205,671747,13458,2.0,HI
180,2020,Jan,60.9,59.7,685559,671319,14240,2.1,HI
181,2020,Feb,60.9,59.6,685148,670279,14869,2.2,HI
182,2020,Mar,60.8,59.5,684233,669113,15120,2.2,HI
183,2020,Apr,57.4,44.5,645069,500444,144625,22.4,HI
184,2020,May,58.7,46.5,660015,522349,137666,20.9,HI
185,2020,Jun,58.8,48.4,660242,543375,116867,17.7,HI
186,2020,Jul,59.8,50.1,671547,562908,108639,16.2,HI
187,2020,Aug,59.8,51.5,671577,578316,93261,13.9,HI
188,2020,Sep,55.4,47.5,621205,532877,88328,14.2,HI
189,2020,Oct,57.3,50.4,642471,564967,77504,12.1,HI
190,2020,Nov,58.1,51.9,651730,581486,70244,10.8,HI
191,2020,Dec,58.8,53.1,658833,594415,64418,9.8,HI
192,2021,Jan,58.9,54.0,659102,604294,54808,8.3,HI
193,2021,Feb,59.0,54.7,660593,612198,48395,7.3,HI
194,2021,Mar,59.3,55.3,662910,618852,44058,6.6,HI
195,2021,Apr,59.7,55.9,666715,624544,42171,6.3,HI
196,2021,May,59.8,56.3,668460,629314,39146,5.9,HI
197,2021,Jun,60.3,56.7,673261,633345,39916,5.9,HI
198,2021,Jul,60.3,57.0,673359,636168,37191,5.5,HI
199,2021,Aug,60.4,57.2,674105,638284,35821,5.3,HI
200,2021,Sep,60.2,57.3,672069,639636,32433,4.8,HI
201,2021,Oct,60.3,57.4,672416,640962,31454,4.7,HI
202,2021,Nov,60.1,57.5,671162,641748,29414,4.4,HI
203,2021,Dec,60.2,57.6,671468,642577,28891,4.3,HI
204,2022,Jan,60.4,57.8,673171,644176,28995,4.3,HI
205,2022,Feb,60.3,57.8,672596,644351,28245,4.2,HI
206,2022,Mar,60.3,57.9,672259,644937,27322,4.1,HI
207,2022,Apr,60.5,58.0,673630,645677,27953,4.1,HI
208,2022,May,60.7,58.1,675608,647613,27995,4.1,HI
209,2022,Jun,60.8,58.2,676640,648325,28315,4.2,HI
210,2022,Jul,60.8,58.3,676740,649492,27248,4.0,HI
211,2022,Aug,61.0,58.5,678994,651640,27354,4.0,HI
212,2022,Sep,60.8,58.7,676762,653244,23518,3.5,HI
213,2022,Oct,60.8,58.8,676699,654052,22647,3.3,HI
214,2022,Nov,60.6,58.6,674524,652291,22233,3.3,HI
0,2005,Jan,61.1,57.7,2045557,1931637,113920,5.6,LA
1,2005,Feb,61.1,57.7,2047645,1933747,113898,5.6,LA
2,2005,Mar,61.2,57.8,2049886,1936392,113494,5.5,LA
3,2005,Apr,61.2,57.9,2052828,1939964,112864,5.5,LA
4,2005,May,61.3,57.9,2055560,1943455,112105,5.5,LA
5,2005,Jun,61.3,57.9,2056231,1944466,111765,5.4,LA
6,2005,Jul,61.2,57.8,2053798,1941390,112408,5.5,LA
7,2005,Aug,60.9,57.5,2048166,1934284,113882,5.6,LA
8,2005,Sep,68.7,60.9,2173136,1924844,248292,11.4,LA
9,2005,Oct,68.4,60.6,2163281,1915795,247486,11.4,LA
10,2005,Nov,68.1,60.4,2153374,1909121,244253,11.3,LA
11,2005,Dec,64.3,60.2,2035834,1905605,130229,6.4,LA
12,2006,Jan,63.3,60.2,2003932,1905404,98528,4.9,LA
13,2006,Feb,63.1,60.2,1998960,1907657,91303,4.6,LA
14,2006,Mar,62.8,60.2,1995431,1910602,84829,4.3,LA
15,2006,Apr,62.7,60.1,1992841,1912614,80227,4.0,LA
16,2006,May,62.5,60.1,1991641,1913803,77838,3.9,LA
17,2006,Jun,62.4,60.0,1992413,1915199,77214,3.9,LA
18,2006,Jul,62.4,60.0,1994902,1917341,77561,3.9,LA
19,2006,Aug,62.4,59.9,1998749,1920481,78268,3.9,LA
20,2006,Sep,62.3,59.9,2003637,1924375,79262,4.0,LA
21,2006,Oct,62.4,59.9,2009343,1928865,80478,4.0,LA
22,2006,Nov,62.4,59.8,2015113,1933463,81650,4.1,LA
23,2006,Dec,62.4,59.8,2019911,1937175,82736,4.1,LA
24,2007,Jan,62.3,59.7,2022840,1939101,83739,4.1,LA
25,2007,Feb,62.2,59.6,2023956,1939168,84788,4.2,LA
26,2007,Mar,62.0,59.4,2023695,1937949,85746,4.2,LA
27,2007,Apr,61.8,59.2,2022494,1936224,86270,4.3,LA
28,2007,May,61.6,59.0,2020880,1934816,86064,4.3,LA
29,2007,Jun,61.4,58.8,2019628,1934783,84845,4.2,LA
30,2007,Jul,61.3,58.8,2020024,1937021,83003,4.1,LA
31,2007,Aug,61.3,58.8,2022752,1941466,81286,4.0,LA
32,2007,Sep,61.3,58.9,2027354,1947292,80062,3.9,LA
33,2007,Oct,61.4,58.9,2032731,1952978,79753,3.9,LA
34,2007,Nov,61.4,59.0,2038038,1957597,80441,3.9,LA
35,2007,Dec,61.5,59.0,2042821,1961120,81701,4.0,LA
36,2008,Jan,61.5,59.0,2046613,1963488,83125,4.1,LA
37,2008,Feb,61.5,59.0,2049281,1964932,84349,4.1,LA
38,2008,Mar,61.5,58.9,2051196,1966079,85117,4.1,LA
39,2008,Apr,61.4,58.9,2053498,1967590,85908,4.2,LA
40,2008,May,61.5,58.8,2057291,1969706,87585,4.3,LA
41,2008,Jun,61.5,58.8,2062672,1971996,90676,4.4,LA
42,2008,Jul,61.6,58.8,2068708,1973844,94864,4.6,LA
43,2008,Aug,61.7,58.8,2074146,1974665,99481,4.8,LA
44,2008,Sep,61.8,58.7,2078215,1974007,104208,5.0,LA
45,2008,Oct,61.8,58.6,2080286,1971443,108843,5.2,LA
46,2008,Nov,61.7,58.4,2080055,1966607,113448,5.5,LA
47,2008,Dec,61.6,58.1,2078009,1959715,118294,5.7,LA
48,2009,Jan,61.5,57.8,2075125,1951613,123512,6.0,LA
49,2009,Feb,61.4,57.5,2072767,1943568,129199,6.2,LA
50,2009,Mar,61.3,57.3,2072027,1936935,135092,6.5,LA
51,2009,Apr,61.3,57.1,2072391,1932168,140223,6.8,LA
52,2009,May,61.2,57.0,2072526,1928778,143748,6.9,LA
53,2009,Jun,61.2,56.9,2071821,1926334,145487,7.0,LA
54,2009,Jul,61.1,56.8,2069984,1924210,145774,7.0,LA
55,2009,Aug,60.9,56.6,2067196,1921831,145365,7.0,LA
56,2009,Sep,60.8,56.5,2064076,1919181,144895,7.0,LA
57,2009,Oct,60.6,56.4,2061211,1916572,144639,7.0,LA
58,2009,Nov,60.6,56.3,2059990,1915071,144919,7.0,LA
59,2009,Dec,60.6,56.3,2061538,1915554,145984,7.1,LA
60,2010,Jan,60.6,56.3,2065893,1918232,147661,7.1,LA
61,2010,Feb,60.8,56.4,2071784,1922452,149332,7.2,LA
62,2010,Mar,60.9,56.5,2077866,1927051,150815,7.3,LA
63,2010,Apr,60.7,56.2,2083571,1931260,152311,7.3,LA
64,2010,May,60.8,56.3,2088368,1934470,153898,7.4,LA
65,2010,Jun,60.8,56.3,2091461,1935671,155790,7.4,LA
66,2010,Jul,60.8,56.2,2092507,1934492,158015,7.6,LA
67,2010,Aug,60.7,56.0,2091887,1931705,160182,7.7,LA
68,2010,Sep,60.6,55.9,2090381,1928355,162026,7.8,LA
69,2010,Oct,60.5,55.7,2089083,1925719,163364,7.8,LA
70,2010,Nov,60.4,55.7,2088150,1924248,163902,7.8,LA
71,2010,Dec,60.3,55.6,2087244,1923828,163416,7.8,LA
72,2011,Jan,60.2,55.6,2086142,1924090,162052,7.8,LA
73,2011,Feb,60.1,55.5,2084405,1924223,160182,7.7,LA
74,2011,Mar,60.0,55.5,2081558,1923559,157999,7.6,LA
75,2011,Apr,59.9,55.4,2077821,1922007,155814,7.5,LA
76,2011,May,59.7,55.3,2074388,1920250,154138,7.4,LA
77,2011,Jun,59.6,55.2,2072589,1919502,153087,7.4,LA
78,2011,Jul,59.6,55.2,2073250,1920667,152583,7.4,LA
79,2011,Aug,59.6,55.2,2076019,1923582,152437,7.3,LA
80,2011,Sep,59.7,55.3,2079673,1927408,152265,7.3,LA
81,2011,Oct,59.7,55.4,2083093,1931181,151912,7.3,LA
82,2011,Nov,59.8,55.4,2085470,1934241,151229,7.3,LA
83,2011,Dec,59.8,55.5,2086631,1936543,150088,7.2,LA
84,2012,Jan,59.8,55.5,2087233,1938549,148684,7.1,LA
85,2012,Feb,59.8,55.5,2088242,1940786,147456,7.1,LA
86,2012,Mar,59.8,55.6,2089768,1943114,146654,7.0,LA
87,2012,Apr,59.8,55.6,2090997,1945016,145981,7.0,LA
88,2012,May,59.8,55.6,2091414,1946434,144980,6.9,LA
89,2012,Jun,59.7,55.6,2090759,1947689,143070,6.8,LA
90,2012,Jul,59.6,55.6,2089201,1949077,140124,6.7,LA
91,2012,Aug,59.6,55.7,2087894,1950819,137075,6.6,LA
92,2012,Sep,59.5,55.7,2088122,1953077,135045,6.5,LA
93,2012,Oct,59.5,55.7,2089992,1955491,134501,6.4,LA
94,2012,Nov,59.6,55.7,2092996,1957453,135543,6.5,LA
95,2012,Dec,59.7,55.7,2096245,1958519,137726,6.6,LA
96,2013,Jan,59.7,55.7,2098900,1958670,140230,6.7,LA
97,2013,Feb,59.7,55.7,2100577,1958498,142079,6.8,LA
98,2013,Mar,59.7,55.7,2101504,1958880,142624,6.8,LA
99,2013,Apr,59.7,55.7,2102390,1960578,141812,6.7,LA
100,2013,May,59.7,55.7,2103144,1963094,140050,6.7,LA
101,2013,Jun,59.7,55.8,2103648,1965593,138055,6.6,LA
102,2013,Jul,59.7,55.8,2103958,1967784,136174,6.5,LA
103,2013,Aug,59.6,55.8,2103449,1969745,133704,6.4,LA
104,2013,Sep,59.5,55.8,2102001,1971714,130287,6.2,LA
105,2013,Oct,59.5,55.9,2100686,1974140,126546,6.0,LA
106,2013,Nov,59.4,56.0,2100476,1977442,123034,5.9,LA
107,2013,Dec,59.4,56.0,2101607,1981332,120275,5.7,LA
108,2014,Jan,59.5,56.1,2103844,1985316,118528,5.6,LA
109,2014,Feb,59.5,56.2,2107066,1989022,118044,5.6,LA
110,2014,Mar,59.7,56.3,2111847,1992426,119421,5.7,LA
111,2014,Apr,59.8,56.3,2118328,1995649,122679,5.8,LA
112,2014,May,60.0,56.4,2126535,1999443,127092,6.0,LA
113,2014,Jun,60.3,56.5,2136367,2004372,131995,6.2,LA
114,2014,Jul,60.5,56.7,2146989,2010030,136959,6.4,LA
115,2014,Aug,60.8,56.8,2157540,2015914,141626,6.6,LA
116,2014,Sep,61.0,56.9,2166638,2021167,145471,6.7,LA
117,2014,Oct,61.1,57.0,2172611,2024800,147811,6.8,LA
118,2014,Nov,61.2,57.0,2174782,2026322,148460,6.8,LA
119,2014,Dec,61.1,57.0,2174213,2026255,147958,6.8,LA
120,2015,Jan,61.0,56.9,2172224,2025344,146880,6.8,LA
121,2015,Feb,60.9,56.8,2169594,2024043,145551,6.7,LA
122,2015,Mar,60.8,56.8,2166522,2022881,143641,6.6,LA
123,2015,Apr,60.7,56.7,2162787,2021790,140997,6.5,LA
124,2015,May,60.5,56.7,2158261,2020294,137967,6.4,LA
125,2015,Jun,60.4,56.6,2152853,2017960,134893,6.3,LA
126,2015,Jul,60.2,56.5,2146855,2014908,131947,6.1,LA
127,2015,Aug,60.0,56.3,2141096,2011545,129551,6.1,LA
128,2015,Sep,59.8,56.2,2136562,2008611,127951,6.0,LA
129,2015,Oct,59.7,56.1,2134141,2006830,127311,6.0,LA
130,2015,Nov,59.7,56.1,2133748,2006151,127597,6.0,LA
131,2015,Dec,59.7,56.1,2134220,2005983,128237,6.0,LA
132,2016,Jan,59.7,56.1,2134557,2005777,128780,6.0,LA
133,2016,Feb,59.6,56.0,2134491,2005278,129213,6.1,LA
134,2016,Mar,59.6,56.0,2133521,2004061,129460,6.1,LA
135,2016,Apr,59.5,55.9,2131830,2002097,129733,6.1,LA
136,2016,May,59.4,55.8,2129860,1999764,130096,6.1,LA
137,2016,Jun,59.4,55.7,2127524,1997206,130318,6.1,LA
138,2016,Jul,59.3,55.6,2124777,1994428,130349,6.1,LA
139,2016,Aug,59.2,55.5,2121376,1991224,130152,6.1,LA
140,2016,Sep,59.0,55.4,2117470,1987810,129660,6.1,LA
141,2016,Oct,58.9,55.3,2113467,1984845,128622,6.1,LA
142,2016,Nov,58.8,55.3,2110081,1983120,126961,6.0,LA
143,2016,Dec,58.8,55.3,2107951,1982995,124956,5.9,LA
144,2017,Jan,58.8,55.4,2108478,1985716,122762,5.8,LA
145,2017,Feb,58.8,55.5,2108908,1988965,119943,5.7,LA
146,2017,Mar,58.8,55.6,2109114,1992398,116716,5.5,LA
147,2017,Apr,58.8,55.7,2109123,1995730,113393,5.4,LA
148,2017,May,58.8,55.7,2108626,1998677,109949,5.2,LA
149,2017,Jun,58.8,55.8,2107721,2000996,106725,5.1,LA
150,2017,Jul,58.8,55.9,2106949,2002832,104117,4.9,LA
151,2017,Aug,58.7,55.9,2106561,2004515,102046,4.8,LA
152,2017,Sep,58.7,55.9,2106373,2005913,100460,4.8,LA
153,2017,Oct,58.7,56.0,2106403,2006969,99434,4.7,LA
154,2017,Nov,58.8,56.0,2107102,2008039,99063,4.7,LA
155,2017,Dec,58.8,56.0,2108887,2009776,99111,4.7,LA
156,2018,Jan,58.9,56.1,2112103,2012307,99796,4.7,LA
157,2018,Feb,59.0,56.2,2116516,2015356,101160,4.8,LA
158,2018,Mar,59.2,56.3,2120755,2018008,102747,4.8,LA
159,2018,Apr,59.2,56.3,2122681,2018850,103831,4.9,LA
160,2018,May,59.2,56.3,2121315,2017213,104102,4.9,LA
161,2018,Jun,59.1,56.2,2117268,2013800,103468,4.9,LA
162,2018,Jul,58.9,56.1,2111633,2009598,102035,4.8,LA
163,2018,Aug,58.8,56.0,2106387,2005687,100700,4.8,LA
164,2018,Sep,58.7,55.9,2103348,2002980,100368,4.8,LA
165,2018,Oct,58.6,55.8,2102973,2001988,100985,4.8,LA
166,2018,Nov,58.7,55.9,2104600,2002758,101842,4.8,LA
167,2018,Dec,58.8,55.9,2107218,2005129,102089,4.8,LA
168,2019,Jan,58.8,56.0,2109622,2008556,101066,4.8,LA
169,2019,Feb,58.9,56.1,2110451,2011922,98529,4.7,LA
170,2019,Mar,58.9,56.2,2109424,2013987,95437,4.5,LA
171,2019,Apr,58.8,56.2,2107367,2014589,92778,4.4,LA
172,2019,May,58.7,56.2,2104995,2013775,91220,4.3,LA
173,2019,Jun,58.7,56.1,2103166,2011979,91187,4.3,LA
174,2019,Jul,58.7,56.1,2102674,2009816,92858,4.4,LA
175,2019,Aug,58.7,56.0,2103911,2008124,95787,4.6,LA
176,2019,Sep,58.8,56.0,2106812,2008088,98724,4.7,LA
177,2019,Oct,58.9,56.0,2110529,2008999,101530,4.8,LA
178,2019,Nov,58.9,56.0,2113054,2008729,104325,4.9,LA
179,2019,Dec,58.9,55.9,2111963,2005055,106908,5.1,LA
180,2020,Jan,58.8,55.7,2107062,1998238,108824,5.2,LA
181,2020,Feb,58.6,55.5,2100460,1990629,109831,5.2,LA
182,2020,Mar,59.4,55.4,2129984,1985735,144249,6.8,LA
183,2020,Apr,55.5,48.0,1988419,1719078,269341,13.5,LA
184,2020,May,56.6,49.6,2026490,1777005,249485,12.3,LA
185,2020,Jun,56.7,50.5,2031092,1806775,224317,11.0,LA
186,2020,Jul,57.4,51.4,2054032,1838704,215328,10.5,LA
187,2020,Aug,57.5,52.1,2056793,1864094,192699,9.4,LA
188,2020,Sep,57.8,52.7,2068168,1884721,183447,8.9,LA
189,2020,Oct,57.6,53.0,2061330,1897015,164315,8.0,LA
190,2020,Nov,57.6,53.3,2059406,1905998,153408,7.4,LA
191,2020,Dec,57.6,53.5,2058216,1913619,144597,7.0,LA
192,2021,Jan,57.5,53.8,2054678,1920919,133759,6.5,LA
193,2021,Feb,57.6,54.0,2056686,1928050,128636,6.3,LA
194,2021,Mar,57.8,54.2,2062079,1935637,126442,6.1,LA
195,2021,Apr,57.9,54.4,2067819,1942197,125622,6.1,LA
196,2021,May,58.0,54.6,2069990,1947251,122739,5.9,LA
197,2021,Jun,58.1,54.7,2071002,1950121,120881,5.8,LA
198,2021,Jul,57.9,54.7,2064982,1951720,113262,5.5,LA
199,2021,Aug,57.8,54.8,2060422,1953709,106713,5.2,LA
200,2021,Sep,57.7,54.9,2056962,1957465,99497,4.8,LA
201,2021,Oct,57.7,55.0,2058294,1962589,95705,4.6,LA
202,2021,Nov,57.7,55.1,2060428,1967435,92993,4.5,LA
203,2021,Dec,57.8,55.2,2062572,1971316,91256,4.4,LA
204,2022,Jan,58.0,55.5,2069077,1979269,89808,4.3,LA
205,2022,Feb,58.2,55.7,2078228,1988953,89275,4.3,LA
206,2022,Mar,58.6,56.1,2089736,2001958,87778,4.2,LA
207,2022,Apr,58.9,56.4,2100393,2013629,86764,4.1,LA
208,2022,May,59.0,56.7,2107360,2023896,83464,4.0,LA
209,2022,Jun,59.0,56.8,2107721,2027943,79778,3.8,LA
210,2022,Jul,58.9,56.8,2104515,2027639,76876,3.7,LA
211,2022,Aug,58.7,56.6,2096105,2022210,73895,3.5,LA
212,2022,Sep,58.5,56.5,2089870,2019585,70285,3.4,LA
213,2022,Oct,58.3,56.4,2083830,2015800,68030,3.3,LA
214,2022,Nov,58.3,56.4,2084843,2016483,68360,3.3,LA
0,2005,Jan,61.5,57.3,1317464,1227658,89806,6.8,MS
1,2005,Feb,61.5,57.3,1319560,1228513,91047,6.9,MS
2,2005,Mar,61.6,57.3,1321680,1229790,91890,7.0,MS
3,2005,Apr,61.7,57.3,1324117,1231424,92693,7.0,MS
4,2005,May,61.8,57.4,1326831,1233270,93561,7.1,MS
5,2005,Jun,61.8,57.4,1329527,1234991,94536,7.1,MS
6,2005,Jul,61.9,57.5,1331761,1236213,95548,7.2,MS
7,2005,Aug,61.8,57.4,1332744,1236730,96014,7.2,MS
8,2005,Sep,61.0,55.0,1316504,1187304,129200,9.8,MS
9,2005,Oct,61.4,55.9,1303895,1186924,116971,9.0,MS
10,2005,Nov,61.1,55.9,1297935,1186645,111290,8.6,MS
11,2005,Dec,60.4,55.8,1283148,1186761,96387,7.5,MS
12,2006,Jan,59.9,55.8,1275110,1187661,87449,6.9,MS
13,2006,Feb,59.8,55.8,1272806,1189293,83513,6.6,MS
14,2006,Mar,59.5,55.8,1271087,1191197,79890,6.3,MS
15,2006,Apr,59.5,55.7,1272591,1193090,79501,6.2,MS
16,2006,May,59.4,55.7,1274797,1195081,79716,6.3,MS
17,2006,Jun,59.4,55.7,1277358,1197221,80137,6.3,MS
18,2006,Jul,59.4,55.7,1280178,1199699,80479,6.3,MS
19,2006,Aug,59.5,55.8,1283338,1202508,80830,6.3,MS
20,2006,Sep,59.6,55.8,1286478,1205340,81138,6.3,MS
21,2006,Oct,59.7,55.9,1289198,1207813,81385,6.3,MS
22,2006,Nov,59.7,56.0,1291444,1209651,81793,6.3,MS
23,2006,Dec,59.8,56.0,1292752,1210528,82224,6.4,MS
24,2007,Jan,59.7,55.9,1292826,1210328,82498,6.4,MS
25,2007,Feb,59.7,55.8,1291912,1209476,82436,6.4,MS
26,2007,Mar,59.6,55.8,1290406,1208538,81868,6.3,MS
27,2007,Apr,59.5,55.7,1288973,1208054,80919,6.3,MS
28,2007,May,59.4,55.7,1288212,1208301,79911,6.2,MS
29,2007,Jun,59.4,55.7,1288461,1209455,79006,6.1,MS
30,2007,Jul,59.4,55.8,1289829,1211517,78312,6.1,MS
31,2007,Aug,59.5,55.9,1292419,1214328,78091,6.0,MS
32,2007,Sep,59.6,56.0,1295815,1217572,78243,6.0,MS
33,2007,Oct,59.7,56.1,1299111,1220565,78546,6.0,MS
34,2007,Nov,59.8,56.1,1301574,1222882,78692,6.0,MS
35,2007,Dec,59.8,56.2,1303016,1224337,78679,6.0,MS
36,2008,Jan,59.8,56.2,1303465,1224659,78806,6.0,MS
37,2008,Feb,59.7,56.1,1302924,1223753,79171,6.1,MS
38,2008,Mar,59.6,56.0,1301731,1221681,80050,6.1,MS
39,2008,Apr,59.5,55.8,1300119,1218522,81597,6.3,MS
40,2008,May,59.4,55.6,1298265,1214621,83644,6.4,MS
41,2008,Jun,59.3,55.4,1296313,1210483,85830,6.6,MS
42,2008,Jul,59.2,55.1,1293981,1206270,87711,6.8,MS
43,2008,Aug,59.0,54.9,1291079,1201959,89120,6.9,MS
44,2008,Sep,58.8,54.7,1287989,1197500,90489,7.0,MS
45,2008,Oct,58.6,54.4,1285225,1192839,92386,7.2,MS
46,2008,Nov,58.5,54.2,1282861,1187659,95202,7.4,MS
47,2008,Dec,58.4,53.9,1280995,1181857,99138,7.7,MS
48,2009,Jan,58.3,53.6,1279561,1175741,103820,8.1,MS
49,2009,Feb,58.2,53.3,1278354,1169822,108532,8.5,MS
50,2009,Mar,58.2,53.0,1277088,1164570,112518,8.8,MS
51,2009,Apr,58.1,52.8,1275427,1160113,115314,9.0,MS
52,2009,May,57.9,52.6,1272969,1155919,117050,9.2,MS
53,2009,Jun,57.7,52.4,1269700,1151486,118214,9.3,MS
54,2009,Jul,57.6,52.1,1266095,1146754,119341,9.4,MS
55,2009,Aug,57.4,51.9,1262789,1141924,120865,9.6,MS
56,2009,Sep,57.2,51.6,1260410,1137403,123007,9.8,MS
57,2009,Oct,57.2,51.4,1259466,1133784,125682,10.0,MS
58,2009,Nov,57.2,51.3,1260322,1131805,128517,10.2,MS
59,2009,Dec,57.3,51.3,1262711,1131753,130958,10.4,MS
60,2010,Jan,57.4,51.4,1265805,1133350,132455,10.5,MS
61,2010,Feb,57.5,51.5,1268874,1135839,133035,10.5,MS
62,2010,Mar,57.6,51.6,1271407,1138614,132793,10.4,MS
63,2010,Apr,57.1,51.2,1273382,1141411,131971,10.4,MS
64,2010,May,57.2,51.3,1274962,1144100,130862,10.3,MS
65,2010,Jun,58.6,52.8,1309109,1179145,129964,9.9,MS
66,2010,Jul,59.4,53.6,1326873,1196962,129911,9.8,MS
67,2010,Aug,59.8,53.9,1336480,1205884,130596,9.8,MS
68,2010,Sep,60.0,54.1,1341711,1210162,131549,9.8,MS
69,2010,Oct,60.1,54.2,1344467,1212089,132378,9.8,MS
70,2010,Nov,60.1,54.2,1345720,1212871,132849,9.9,MS
71,2010,Dec,60.1,54.2,1346211,1213311,132900,9.9,MS
72,2011,Jan,60.1,54.2,1346725,1213959,132766,9.9,MS
73,2011,Feb,60.1,54.2,1347354,1214734,132620,9.8,MS
74,2011,Mar,60.1,54.2,1347717,1215162,132555,9.8,MS
75,2011,Apr,60.1,54.2,1347672,1214885,132787,9.9,MS
76,2011,May,60.1,54.1,1347406,1214100,133306,9.9,MS
77,2011,Jun,60.0,54.1,1347132,1213310,133822,9.9,MS
78,2011,Jul,60.0,54.0,1346784,1212959,133825,9.9,MS
79,2011,Aug,59.9,54.0,1346413,1213238,133175,9.9,MS
80,2011,Sep,59.9,54.0,1346047,1214189,131858,9.8,MS
81,2011,Oct,59.8,54.1,1345330,1215492,129838,9.7,MS
82,2011,Nov,59.8,54.1,1343817,1216515,127302,9.5,MS
83,2011,Dec,59.6,54.1,1341351,1216791,124560,9.3,MS
84,2012,Jan,59.5,54.1,1338147,1216211,121936,9.1,MS
85,2012,Feb,59.3,54.0,1334895,1215042,119853,9.0,MS
86,2012,Mar,59.2,53.9,1332365,1213667,118698,8.9,MS
87,2012,Apr,59.1,53.8,1330658,1212323,118335,8.9,MS
88,2012,May,59.0,53.8,1329787,1211394,118393,8.9,MS
89,2012,Jun,59.0,53.8,1329476,1211194,118282,8.9,MS
90,2012,Jul,59.0,53.8,1329451,1211838,117613,8.8,MS
91,2012,Aug,59.0,53.8,1329468,1212890,116578,8.8,MS
92,2012,Sep,58.9,53.8,1329339,1213704,115635,8.7,MS
93,2012,Oct,58.9,53.8,1328815,1213839,114976,8.7,MS
94,2012,Nov,58.8,53.7,1327884,1213261,114623,8.6,MS
95,2012,Dec,58.7,53.7,1326506,1212063,114443,8.6,MS
96,2013,Jan,58.3,53.2,1316549,1202216,114333,8.7,MS
97,2013,Feb,57.8,52.8,1306538,1192627,113911,8.7,MS
98,2013,Mar,57.4,52.4,1296897,1183985,112912,8.7,MS
99,2013,Apr,57.0,52.0,1288199,1176746,111453,8.7,MS
100,2013,May,56.6,51.7,1280192,1170333,109859,8.6,MS
101,2013,Jun,56.2,51.4,1272370,1163744,108626,8.5,MS
102,2013,Jul,56.0,51.2,1268048,1160302,107746,8.5,MS
103,2013,Aug,55.4,50.7,1254811,1148171,106640,8.5,MS
104,2013,Sep,55.3,50.6,1252815,1147763,105052,8.4,MS
105,2013,Oct,55.2,50.6,1250602,1147147,103455,8.3,MS
106,2013,Nov,55.1,50.6,1248764,1146573,102191,8.2,MS
107,2013,Dec,55.0,50.5,1247492,1146243,101249,8.1,MS
108,2014,Jan,54.9,50.5,1246805,1146363,100442,8.1,MS
109,2014,Feb,54.9,50.5,1246453,1146767,99686,8.0,MS
110,2014,Mar,54.9,50.5,1246033,1147012,99021,7.9,MS
111,2014,Apr,54.8,50.5,1245010,1146757,98253,7.9,MS
112,2014,May,54.8,50.5,1243633,1146391,97242,7.8,MS
113,2014,Jun,54.7,50.5,1242518,1146590,95928,7.7,MS
114,2014,Jul,54.6,50.5,1241849,1147388,94461,7.6,MS
115,2014,Aug,54.6,50.5,1241705,1148638,93067,7.5,MS
116,2014,Sep,54.6,50.6,1241870,1150211,91659,7.4,MS
117,2014,Oct,54.6,50.6,1242310,1152316,89994,7.2,MS
118,2014,Nov,54.6,50.8,1243119,1155075,88044,7.1,MS
119,2014,Dec,54.7,50.9,1244773,1158482,86291,6.9,MS
120,2015,Jan,54.8,51.1,1247332,1162332,85000,6.8,MS
121,2015,Feb,54.9,51.2,1250514,1166324,84190,6.7,MS
122,2015,Mar,55.1,51.4,1253923,1170356,83567,6.7,MS
123,2015,Apr,55.2,51.6,1257058,1174188,82870,6.6,MS
124,2015,May,55.3,51.7,1259289,1177336,81953,6.5,MS
125,2015,Jun,55.3,51.8,1260313,1179455,80858,6.4,MS
126,2015,Jul,55.3,51.8,1260827,1180794,80033,6.3,MS
127,2015,Aug,55.3,51.8,1261680,1181932,79748,6.3,MS
128,2015,Sep,55.4,51.9,1263353,1183427,79926,6.3,MS
129,2015,Oct,55.5,52.0,1265802,1185416,80386,6.4,MS
130,2015,Nov,55.6,52.1,1268447,1187642,80805,6.4,MS
131,2015,Dec,55.7,52.1,1270497,1189803,80694,6.4,MS
132,2016,Jan,55.7,52.2,1271520,1191631,79889,6.3,MS
133,2016,Feb,55.7,52.3,1271510,1192863,78647,6.2,MS
134,2016,Mar,55.7,52.3,1270710,1193455,77255,6.1,MS
135,2016,Apr,55.6,52.3,1269674,1193563,76111,6.0,MS
136,2016,May,55.6,52.3,1269210,1193670,75540,6.0,MS
137,2016,Jun,55.6,52.3,1269750,1194254,75496,5.9,MS
138,2016,Jul,55.6,52.3,1270922,1195416,75506,5.9,MS
139,2016,Aug,55.7,52.4,1272319,1196860,75459,5.9,MS
140,2016,Sep,55.7,52.4,1273642,1198270,75372,5.9,MS
141,2016,Oct,55.7,52.4,1274607,1199606,75001,5.9,MS
142,2016,Nov,55.7,52.5,1275297,1201112,74185,5.8,MS
143,2016,Dec,55.7,52.6,1275809,1202794,73015,5.7,MS
144,2017,Jan,55.8,52.7,1274598,1203082,71516,5.6,MS
145,2017,Feb,55.8,52.7,1274798,1204659,70139,5.5,MS
146,2017,Mar,55.8,52.8,1275006,1205901,69105,5.4,MS
147,2017,Apr,55.8,52.8,1275266,1206831,68435,5.4,MS
148,2017,May,55.8,52.9,1275453,1207603,67850,5.3,MS
149,2017,Jun,55.8,52.9,1275119,1207857,67262,5.3,MS
150,2017,Jul,55.8,52.8,1274114,1207439,66675,5.2,MS
151,2017,Aug,55.7,52.8,1272449,1206728,65721,5.2,MS
152,2017,Sep,55.6,52.8,1270213,1205682,64531,5.1,MS
153,2017,Oct,55.5,52.8,1268736,1205286,63450,5.0,MS
154,2017,Nov,55.5,52.7,1267423,1204790,62633,4.9,MS
155,2017,Dec,55.5,52.8,1266891,1204763,62128,4.9,MS
156,2018,Jan,55.5,52.8,1267217,1205247,61970,4.9,MS
157,2018,Feb,55.6,52.9,1268509,1206476,62033,4.9,MS
158,2018,Mar,55.7,53.0,1270468,1208351,62117,4.9,MS
159,2018,Apr,55.8,53.0,1271609,1209519,62090,4.9,MS
160,2018,May,55.8,53.1,1271515,1209571,61944,4.9,MS
161,2018,Jun,55.7,53.0,1270120,1208494,61626,4.9,MS
162,2018,Jul,55.6,52.9,1267726,1206401,61325,4.8,MS
163,2018,Aug,55.5,52.8,1266058,1204495,61563,4.9,MS
164,2018,Sep,55.5,52.7,1264930,1202400,62530,4.9,MS
165,2018,Oct,55.5,52.7,1265014,1201035,63979,5.1,MS
166,2018,Nov,55.5,52.6,1266200,1200511,65689,5.2,MS
167,2018,Dec,55.6,52.7,1268060,1201000,67060,5.3,MS
168,2019,Jan,55.7,52.7,1269731,1202017,67714,5.3,MS
169,2019,Feb,55.8,52.8,1271071,1203358,67713,5.3,MS
170,2019,Mar,55.8,52.9,1272629,1205061,67568,5.3,MS
171,2019,Apr,55.9,52.9,1274482,1206775,67707,5.3,MS
172,2019,May,56.0,53.0,1276671,1208288,68383,5.4,MS
173,2019,Jun,56.1,53.1,1279080,1209458,69622,5.4,MS
174,2019,Jul,56.2,53.1,1280746,1209655,71091,5.6,MS
175,2019,Aug,56.2,53.0,1281662,1209551,72111,5.6,MS
176,2019,Sep,56.2,53.0,1281321,1209352,71969,5.6,MS
177,2019,Oct,56.1,53.0,1280315,1209270,71045,5.5,MS
178,2019,Nov,56.1,53.0,1279361,1209267,70094,5.5,MS
179,2019,Dec,56.0,53.0,1277761,1207905,69856,5.5,MS
180,2020,Jan,55.9,52.8,1275659,1205002,70657,5.5,MS
181,2020,Feb,55.8,52.7,1272737,1200606,72131,5.7,MS
182,2020,Mar,55.7,52.5,1270234,1196738,73496,5.8,MS
183,2020,Apr,52.8,44.7,1204083,1018422,185661,15.4,MS
184,2020,May,53.4,47.5,1216189,1082580,133609,11.0,MS
185,2020,Jun,53.5,48.5,1217805,1105176,112629,9.2,MS
186,2020,Jul,53.9,49.5,1227415,1126978,100437,8.2,MS
187,2020,Aug,54.1,50.2,1233607,1142762,90845,7.4,MS
188,2020,Sep,54.6,50.7,1244268,1156220,88048,7.1,MS
189,2020,Oct,54.8,51.1,1249542,1164123,85419,6.8,MS
190,2020,Nov,55.0,51.3,1253634,1168828,84806,6.8,MS
191,2020,Dec,55.1,51.4,1256098,1171728,84370,6.7,MS
192,2021,Jan,55.2,51.5,1256755,1173485,83270,6.6,MS
193,2021,Feb,55.2,51.6,1257323,1175460,81863,6.5,MS
194,2021,Mar,55.3,51.7,1258348,1178186,80162,6.4,MS
195,2021,Apr,55.3,51.8,1258520,1180285,78235,6.2,MS
196,2021,May,55.2,51.9,1258053,1182114,75939,6.0,MS
197,2021,Jun,55.2,52.0,1256899,1183407,73492,5.8,MS
198,2021,Jul,55.1,52.0,1254521,1184355,70166,5.6,MS
199,2021,Aug,54.9,52.0,1252103,1185881,66222,5.3,MS
200,2021,Sep,54.8,52.1,1250191,1187966,62225,5.0,MS
201,2021,Oct,54.8,52.2,1249556,1190505,59051,4.7,MS
202,2021,Nov,54.8,52.2,1249941,1191529,58412,4.7,MS
203,2021,Dec,54.8,52.2,1250797,1192082,58715,4.7,MS
204,2022,Jan,54.9,52.3,1252196,1194752,57444,4.6,MS
205,2022,Feb,55.0,52.5,1255930,1199456,56474,4.5,MS
206,2022,Mar,55.2,52.8,1259543,1206688,52855,4.2,MS
207,2022,Apr,55.4,53.1,1264202,1212553,51649,4.1,MS
208,2022,May,55.5,53.3,1267619,1217552,50067,3.9,MS
209,2022,Jun,55.5,53.4,1268238,1220415,47823,3.8,MS
210,2022,Jul,55.5,53.5,1268193,1222085,46108,3.6,MS
211,2022,Aug,55.3,53.4,1265752,1220515,45237,3.6,MS
212,2022,Sep,55.2,53.2,1263162,1217240,45922,3.6,MS
213,2022,Oct,55.0,53.0,1259959,1212703,47256,3.8,MS
214,2022,Nov,54.8,52.7,1255705,1206559,49146,3.9,MS
0,2005,Jan,72.9,70.2,427704,411732,15972,3.7,SD
1,2005,Feb,72.9,70.2,428114,412033,16081,3.8,SD
2,2005,Mar,73.0,70.2,428524,412436,16088,3.8,SD
3,2005,Apr,73.0,70.3,428895,412936,15959,3.7,SD
4,2005,May,73.0,70.3,429221,413517,15704,3.7,SD
5,2005,Jun,72.9,70.3,429471,414094,15377,3.6,SD
6,2005,Jul,72.9,70.3,429676,414593,15083,3.5,SD
7,2005,Aug,72.8,70.3,429849,414985,14864,3.5,SD
8,2005,Sep,72.8,70.3,429938,415245,14693,3.4,SD
9,2005,Oct,72.6,70.2,429933,415423,14510,3.4,SD
10,2005,Nov,72.5,70.1,429875,415594,14281,3.3,SD
11,2005,Dec,72.4,70.1,429803,415844,13959,3.2,SD
12,2006,Jan,72.4,70.1,429781,416242,13539,3.2,SD
13,2006,Feb,72.3,70.1,429875,416765,13110,3.0,SD
14,2006,Mar,72.3,70.1,430158,417367,12791,3.0,SD
15,2006,Apr,72.3,70.2,430646,417991,12655,2.9,SD
16,2006,May,72.4,70.2,431321,418628,12693,2.9,SD
17,2006,Jun,72.4,70.3,432138,419282,12856,3.0,SD
18,2006,Jul,72.5,70.3,433034,419998,13036,3.0,SD
19,2006,Aug,72.6,70.3,433934,420774,13160,3.0,SD
20,2006,Sep,72.6,70.4,434769,421551,13218,3.0,SD
21,2006,Oct,72.6,70.4,435472,422293,13179,3.0,SD
22,2006,Nov,72.6,70.5,435997,422938,13059,3.0,SD
23,2006,Dec,72.6,70.5,436286,423393,12893,3.0,SD
24,2007,Jan,72.5,70.4,436333,423609,12724,2.9,SD
25,2007,Feb,72.5,70.4,436230,423663,12567,2.9,SD
26,2007,Mar,72.4,70.3,436036,423614,12422,2.8,SD
27,2007,Apr,72.3,70.2,435857,423544,12313,2.8,SD
28,2007,May,72.2,70.1,435799,423522,12277,2.8,SD
29,2007,Jun,72.1,70.1,435880,423571,12309,2.8,SD
30,2007,Jul,72.1,70.0,436076,423684,12392,2.8,SD
31,2007,Aug,72.0,70.0,436349,423869,12480,2.9,SD
32,2007,Sep,72.0,69.9,436671,424175,12496,2.9,SD
33,2007,Oct,72.0,69.9,436942,424539,12403,2.8,SD
34,2007,Nov,71.9,69.9,437109,424927,12182,2.8,SD
35,2007,Dec,71.9,69.9,437206,425335,11871,2.7,SD
36,2008,Jan,71.8,69.9,437280,425694,11586,2.6,SD
37,2008,Feb,71.8,69.9,437379,425948,11431,2.6,SD
38,2008,Mar,71.8,69.9,437569,426073,11496,2.6,SD
39,2008,Apr,71.8,69.8,437859,426056,11803,2.7,SD
40,2008,May,71.8,69.8,438234,425932,12302,2.8,SD
41,2008,Jun,71.8,69.7,438727,425798,12929,2.9,SD
42,2008,Jul,71.8,69.6,439323,425719,13604,3.1,SD
43,2008,Aug,71.9,69.5,439940,425685,14255,3.2,SD
44,2008,Sep,71.9,69.4,440469,425601,14868,3.4,SD
45,2008,Oct,71.9,69.3,440908,425382,15526,3.5,SD
46,2008,Nov,71.9,69.2,441280,424951,16329,3.7,SD
47,2008,Dec,71.9,69.1,441582,424301,17281,3.9,SD
48,2009,Jan,71.9,68.9,441816,423509,18307,4.1,SD
49,2009,Feb,71.9,68.7,442038,422739,19299,4.4,SD
50,2009,Mar,71.8,68.6,442303,422195,20108,4.5,SD
51,2009,Apr,71.8,68.5,442586,421978,20608,4.7,SD
52,2009,May,71.8,68.4,442719,421946,20773,4.7,SD
53,2009,Jun,71.7,68.4,442568,421904,20664,4.7,SD
54,2009,Jul,71.6,68.3,442080,421666,20414,4.6,SD
55,2009,Aug,71.4,68.1,441357,421142,20215,4.6,SD
56,2009,Sep,71.2,67.9,440625,420427,20198,4.6,SD
57,2009,Oct,71.0,67.7,439992,419656,20336,4.6,SD
58,2009,Nov,70.9,67.5,439639,419064,20575,4.7,SD
59,2009,Dec,70.8,67.4,439775,418867,20908,4.8,SD
60,2010,Jan,70.8,67.4,440408,419140,21268,4.8,SD
61,2010,Feb,70.9,67.5,441293,419724,21569,4.9,SD
62,2010,Mar,71.0,67.5,442184,420409,21775,4.9,SD
63,2010,Apr,71.9,68.3,442991,421101,21890,4.9,SD
64,2010,May,71.9,68.4,443666,421758,21908,4.9,SD
65,2010,Jun,72.0,68.4,444123,422282,21841,4.9,SD
66,2010,Jul,71.9,68.4,444371,422617,21754,4.9,SD
67,2010,Aug,71.9,68.4,444504,422804,21700,4.9,SD
68,2010,Sep,71.8,68.3,444594,422872,21722,4.9,SD
69,2010,Oct,71.8,68.3,444813,422952,21861,4.9,SD
70,2010,Nov,71.8,68.2,445167,423105,22062,5.0,SD
71,2010,Dec,71.8,68.2,445503,423307,22196,5.0,SD
72,2011,Jan,71.8,68.2,445750,423555,22195,5.0,SD
73,2011,Feb,71.8,68.2,445841,423826,22015,4.9,SD
74,2011,Mar,71.7,68.2,445721,424072,21649,4.9,SD
75,2011,Apr,71.6,68.2,445389,424206,21183,4.8,SD
76,2011,May,71.5,68.1,445018,424275,20743,4.7,SD
77,2011,Jun,71.4,68.1,444826,424436,20390,4.6,SD
78,2011,Jul,71.3,68.1,444961,424835,20126,4.5,SD
79,2011,Aug,71.3,68.1,445413,425492,19921,4.5,SD
80,2011,Sep,71.3,68.2,446041,426311,19730,4.4,SD
81,2011,Oct,71.3,68.2,446633,427114,19519,4.4,SD
82,2011,Nov,71.3,68.2,446983,427729,19254,4.3,SD
83,2011,Dec,71.3,68.2,447025,428081,18944,4.2,SD
84,2012,Jan,71.1,68.2,446838,428215,18623,4.2,SD
85,2012,Feb,71.0,68.1,446604,428238,18366,4.1,SD
86,2012,Mar,70.9,68.0,446419,428181,18238,4.1,SD
87,2012,Apr,70.8,68.0,446316,428107,18209,4.1,SD
88,2012,May,70.8,67.9,446395,428150,18245,4.1,SD
89,2012,Jun,70.7,67.8,446684,428374,18310,4.1,SD
90,2012,Jul,70.7,67.8,447093,428772,18321,4.1,SD
91,2012,Aug,70.7,67.8,447503,429274,18229,4.1,SD
92,2012,Sep,70.7,67.8,447850,429788,18062,4.0,SD
93,2012,Oct,70.7,67.8,448011,430176,17835,4.0,SD
94,2012,Nov,70.6,67.8,447969,430360,17609,3.9,SD
95,2012,Dec,70.5,67.7,447801,430364,17437,3.9,SD
96,2013,Jan,70.4,67.7,447554,430244,17310,3.9,SD
97,2013,Feb,70.3,67.6,447340,430138,17202,3.8,SD
98,2013,Mar,70.2,67.6,447292,430213,17079,3.8,SD
99,2013,Apr,70.2,67.6,447485,430546,16939,3.8,SD
100,2013,May,70.2,67.6,447737,430933,16804,3.8,SD
101,2013,Jun,70.1,67.5,447878,431179,16699,3.7,SD
102,2013,Jul,70.1,67.5,447845,431221,16624,3.7,SD
103,2013,Aug,70.0,67.4,447657,431138,16519,3.7,SD
104,2013,Sep,69.9,67.4,447422,431095,16327,3.6,SD
105,2013,Oct,69.8,67.3,447347,431256,16091,3.6,SD
106,2013,Nov,69.8,67.4,447564,431702,15862,3.5,SD
107,2013,Dec,69.9,67.4,448026,432363,15663,3.5,SD
108,2014,Jan,69.9,67.5,448617,433108,15509,3.5,SD
109,2014,Feb,70.0,67.6,449189,433800,15389,3.4,SD
110,2014,Mar,70.0,67.6,449621,434322,15299,3.4,SD
111,2014,Apr,70.0,67.6,449846,434622,15224,3.4,SD
112,2014,May,70.0,67.6,449972,434863,15109,3.4,SD
113,2014,Jun,70.0,67.6,450202,435243,14959,3.3,SD
114,2014,Jul,70.0,67.7,450600,435765,14835,3.3,SD
115,2014,Aug,70.0,67.7,451166,436382,14784,3.3,SD
116,2014,Sep,70.1,67.8,451792,437009,14783,3.3,SD
117,2014,Oct,70.1,67.8,452319,437549,14770,3.3,SD
118,2014,Nov,70.1,67.8,452605,437918,14687,3.2,SD
119,2014,Dec,70.1,67.8,452708,438149,14559,3.2,SD
120,2015,Jan,70.1,67.8,452732,438302,14430,3.2,SD
121,2015,Feb,70.0,67.8,452748,438409,14339,3.2,SD
122,2015,Mar,70.0,67.8,452826,438548,14278,3.2,SD
123,2015,Apr,70.0,67.8,452965,438747,14218,3.1,SD
124,2015,May,70.0,67.8,453080,438941,14139,3.1,SD
125,2015,Jun,69.9,67.8,453071,439062,14009,3.1,SD
126,2015,Jul,69.9,67.8,452987,439168,13819,3.1,SD
127,2015,Aug,69.8,67.7,452923,439326,13597,3.0,SD
128,2015,Sep,69.8,67.7,452976,439607,13369,3.0,SD
129,2015,Oct,69.7,67.7,453249,440079,13170,2.9,SD
130,2015,Nov,69.7,67.7,453718,440691,13027,2.9,SD
131,2015,Dec,69.8,67.8,454211,441285,12926,2.8,SD
132,2016,Jan,69.8,67.8,454613,441752,12861,2.8,SD
133,2016,Feb,69.8,67.8,454907,442042,12865,2.8,SD
134,2016,Mar,69.7,67.8,455081,442131,12950,2.8,SD
135,2016,Apr,69.7,67.7,455173,442044,13129,2.9,SD
136,2016,May,69.6,67.6,455241,441851,13390,2.9,SD
137,2016,Jun,69.6,67.5,455294,441614,13680,3.0,SD
138,2016,Jul,69.5,67.4,455323,441381,13942,3.1,SD
139,2016,Aug,69.4,67.3,455306,441149,14157,3.1,SD
140,2016,Sep,69.4,67.2,455229,440886,14343,3.2,SD
141,2016,Oct,69.3,67.1,455083,440599,14484,3.2,SD
142,2016,Nov,69.2,67.0,454969,440426,14543,3.2,SD
143,2016,Dec,69.1,66.9,455019,440501,14518,3.2,SD
144,2017,Jan,69.2,67.0,453704,439537,14167,3.1,SD
145,2017,Feb,69.2,67.1,454039,440022,14017,3.1,SD
146,2017,Mar,69.2,67.1,454502,440611,13891,3.1,SD
147,2017,Apr,69.2,67.1,455014,441183,13831,3.0,SD
148,2017,May,69.3,67.2,455572,441739,13833,3.0,SD
149,2017,Jun,69.3,67.2,456058,442179,13879,3.0,SD
150,2017,Jul,69.2,67.1,456269,442319,13950,3.1,SD
151,2017,Aug,69.2,67.1,456284,442300,13984,3.1,SD
152,2017,Sep,69.1,67.0,455863,441913,13950,3.1,SD
153,2017,Oct,69.0,66.9,455660,441816,13844,3.0,SD
154,2017,Nov,68.9,66.9,455426,441706,13720,3.0,SD
155,2017,Dec,68.9,66.8,455425,441844,13581,3.0,SD
156,2018,Jan,68.9,66.9,455674,442245,13429,2.9,SD
157,2018,Feb,69.0,67.0,456193,442910,13283,2.9,SD
158,2018,Mar,69.1,67.1,457002,443872,13130,2.9,SD
159,2018,Apr,69.1,67.2,457586,444630,12956,2.8,SD
160,2018,May,69.1,67.2,457874,445072,12802,2.8,SD
161,2018,Jun,69.1,67.2,457891,445209,12682,2.8,SD
162,2018,Jul,69.0,67.1,457564,444997,12567,2.7,SD
163,2018,Aug,68.9,67.0,457350,444861,12489,2.7,SD
164,2018,Sep,68.8,66.9,457086,444601,12485,2.7,SD
165,2018,Oct,68.8,66.9,457297,444743,12554,2.7,SD
166,2018,Nov,68.8,66.9,457818,445152,12666,2.8,SD
167,2018,Dec,68.8,66.9,458497,445721,12776,2.8,SD
168,2019,Jan,68.9,66.9,459122,446252,12870,2.8,SD
169,2019,Feb,68.9,67.0,459608,446687,12921,2.8,SD
170,2019,Mar,68.9,67.0,460186,447226,12960,2.8,SD
171,2019,Apr,69.0,67.0,460748,447747,13001,2.8,SD
172,2019,May,69.0,67.0,461261,448217,13044,2.8,SD
173,2019,Jun,69.0,67.0,461773,448667,13106,2.8,SD
174,2019,Jul,69.0,67.0,462183,448994,13189,2.9,SD
175,2019,Aug,69.0,67.0,462560,449325,13235,2.9,SD
176,2019,Sep,69.0,67.0,462705,449559,13146,2.8,SD
177,2019,Oct,68.9,67.0,462955,450013,12942,2.8,SD
178,2019,Nov,68.9,67.0,463041,450359,12682,2.7,SD
179,2019,Dec,68.8,67.0,462801,450349,12452,2.7,SD
180,2020,Jan,68.7,66.8,461954,449712,12242,2.7,SD
181,2020,Feb,68.4,66.6,460583,448594,11989,2.6,SD
182,2020,Mar,68.2,66.5,459406,447769,11637,2.5,SD
183,2020,Apr,68.1,62.1,459048,418787,40261,8.8,SD
184,2020,May,68.2,63.7,459804,429564,30240,6.6,SD
185,2020,Jun,68.0,64.3,458365,433853,24512,5.3,SD
186,2020,Jul,68.3,65.0,460598,438418,22180,4.8,SD
187,2020,Aug,68.4,65.5,461778,442076,19702,4.3,SD
188,2020,Sep,68.6,65.8,463580,445036,18544,4.0,SD
189,2020,Oct,68.5,66.0,463872,446754,17118,3.7,SD
190,2020,Nov,68.5,66.1,464326,447767,16559,3.6,SD
191,2020,Dec,68.4,66.1,464321,448299,16022,3.5,SD
192,2021,Jan,68.4,66.1,464142,448962,15180,3.3,SD
193,2021,Feb,68.4,66.2,464605,449803,14802,3.2,SD
194,2021,Mar,68.5,66.3,465632,450895,14737,3.2,SD
195,2021,Apr,68.6,66.4,466752,451896,14856,3.2,SD
196,2021,May,68.6,66.4,467651,452714,14937,3.2,SD
197,2021,Jun,68.7,66.5,468573,453423,15150,3.2,SD
198,2021,Jul,68.7,66.5,469129,454017,15112,3.2,SD
199,2021,Aug,68.6,66.5,469504,454643,14861,3.2,SD
200,2021,Sep,68.6,66.5,469655,455264,14391,3.1,SD
201,2021,Oct,68.5,66.5,470035,456056,13979,3.0,SD
202,2021,Nov,68.4,66.4,469944,456238,13706,2.9,SD
203,2021,Dec,68.3,66.3,469909,456290,13619,2.9,SD
204,2022,Jan,68.4,66.5,470664,457696,12968,2.8,SD
205,2022,Feb,68.4,66.6,471304,458880,12424,2.6,SD
206,2022,Mar,68.5,66.8,472682,461045,11637,2.5,SD
207,2022,Apr,68.6,67.0,473832,462785,11047,2.3,SD
208,2022,May,68.8,67.2,475725,465002,10723,2.3,SD
209,2022,Jun,68.9,67.3,477280,466518,10762,2.3,SD
210,2022,Jul,68.9,67.4,478143,467342,10801,2.3,SD
211,2022,Aug,68.9,67.3,478380,467380,11000,2.3,SD
212,2022,Sep,68.7,67.1,478143,467048,11095,2.3,SD
213,2022,Oct,68.6,67.0,477798,466447,11351,2.4,SD
214,2022,Nov,68.4,66.8,477412,466138,11274,2.4,SD
0,2005,Jan,66.2,63.2,422854,404007,18847,4.5,DE
1,2005,Feb,66.3,63.3,424441,405516,18925,4.5,DE
2,2005,Mar,66.5,63.6,426475,407433,19042,4.5,DE
3,2005,Apr,66.8,63.8,428767,409590,19177,4.5,DE
4,2005,May,67.0,64.0,431083,411764,19319,4.5,DE
5,2005,Jun,67.2,64.2,433225,413740,19485,4.5,DE
6,2005,Jul,67.4,64.4,435162,415453,19709,4.5,DE
7,2005,Aug,67.6,64.5,436916,416994,19922,4.6,DE
8,2005,Sep,67.7,64.6,438472,418445,20027,4.6,DE
9,2005,Oct,67.7,64.7,439827,419873,19954,4.5,DE
10,2005,Nov,67.8,64.8,440907,421211,19696,4.5,DE
11,2005,Dec,67.8,64.8,441628,422333,19295,4.4,DE
12,2006,Jan,67.8,64.9,442004,423215,18789,4.3,DE
13,2006,Feb,67.7,64.9,442164,423908,18256,4.1,DE
14,2006,Mar,67.6,64.9,442256,424429,17827,4.0,DE
15,2006,Apr,67.5,64.8,442353,424748,17605,4.0,DE
16,2006,May,67.4,64.8,442483,424936,17547,4.0,DE
17,2006,Jun,67.4,64.7,442683,425140,17543,4.0,DE
18,2006,Jul,67.3,64.7,442992,425528,17464,3.9,DE
19,2006,Aug,67.3,64.7,443425,426171,17254,3.9,DE
20,2006,Sep,67.3,64.7,443955,427015,16940,3.8,DE
21,2006,Oct,67.3,64.8,444511,427949,16562,3.7,DE
22,2006,Nov,67.2,64.8,444980,428750,16230,3.6,DE
23,2006,Dec,67.2,64.8,445217,429217,16000,3.6,DE
24,2007,Jan,67.1,64.7,445183,429285,15898,3.6,DE
25,2007,Feb,67.0,64.6,444987,429060,15927,3.6,DE
26,2007,Mar,66.9,64.5,444654,428670,15984,3.6,DE
27,2007,Apr,66.7,64.3,444310,428349,15961,3.6,DE
28,2007,May,66.6,64.2,444108,428254,15854,3.6,DE
29,2007,Jun,66.5,64.2,444095,428382,15713,3.5,DE
30,2007,Jul,66.5,64.1,444306,428680,15626,3.5,DE
31,2007,Aug,66.5,64.1,444788,429083,15705,3.5,DE
32,2007,Sep,66.5,64.1,445525,429558,15967,3.6,DE
33,2007,Oct,66.5,64.1,446439,430080,16359,3.7,DE
34,2007,Nov,66.6,64.1,447478,430714,16764,3.7,DE
35,2007,Dec,66.7,64.1,448554,431428,17126,3.8,DE
36,2008,Jan,66.7,64.1,449481,432002,17479,3.9,DE
37,2008,Feb,66.7,64.1,450124,432276,17848,4.0,DE
38,2008,Mar,66.7,64.0,450558,432198,18360,4.1,DE
39,2008,Apr,66.7,63.8,450833,431703,19130,4.2,DE
40,2008,May,66.6,63.6,450971,430805,20166,4.5,DE
41,2008,Jun,66.5,63.4,451055,429649,21406,4.7,DE
42,2008,Jul,66.5,63.1,451063,428337,22726,5.0,DE
43,2008,Aug,66.4,62.8,450915,426883,24032,5.3,DE
44,2008,Sep,66.3,62.5,450618,425254,25364,5.6,DE
45,2008,Oct,66.1,62.2,450134,423297,26837,6.0,DE
46,2008,Nov,65.9,61.8,449376,420891,28485,6.3,DE
47,2008,Dec,65.7,61.3,448368,418100,30268,6.8,DE
48,2009,Jan,65.5,60.8,447205,415103,32102,7.2,DE
49,2009,Feb,65.3,60.3,445924,412069,33855,7.6,DE
50,2009,Mar,65.0,59.8,444546,409245,35301,7.9,DE
51,2009,Apr,64.7,59.4,443075,406789,36286,8.2,DE
52,2009,May,64.4,59.1,441440,404596,36844,8.3,DE
53,2009,Jun,64.1,58.7,439569,402469,37100,8.4,DE
54,2009,Jul,63.8,58.3,437522,400274,37248,8.5,DE
55,2009,Aug,63.4,57.9,435435,398014,37421,8.6,DE
56,2009,Sep,63.0,57.6,433494,395820,37674,8.7,DE
57,2009,Oct,62.7,57.2,431859,393847,38012,8.8,DE
58,2009,Nov,62.5,56.9,430762,392346,38416,8.9,DE
59,2009,Dec,62.4,56.8,430322,391519,38803,9.0,DE
60,2010,Jan,62.4,56.7,430527,391523,39004,9.1,DE
61,2010,Feb,62.4,56.8,431248,392300,38948,9.0,DE
62,2010,Mar,62.5,56.9,432340,393640,38700,9.0,DE
63,2010,Apr,61.8,56.4,433690,395333,38357,8.8,DE
64,2010,May,62.0,56.6,435187,397214,37973,8.7,DE
65,2010,Jun,62.1,56.8,436637,398992,37645,8.6,DE
66,2010,Jul,62.2,56.9,437815,400363,37452,8.6,DE
67,2010,Aug,62.3,57.0,438620,401248,37372,8.5,DE
68,2010,Sep,62.3,57.0,439101,401788,37313,8.5,DE
69,2010,Oct,62.3,57.0,439480,402336,37144,8.5,DE
70,2010,Nov,62.3,57.1,439945,403158,36787,8.4,DE
71,2010,Dec,62.3,57.2,440553,404310,36243,8.2,DE
72,2011,Jan,62.3,57.3,441299,405681,35618,8.1,DE
73,2011,Feb,62.4,57.5,442047,407022,35025,7.9,DE
74,2011,Mar,62.4,57.6,442611,408089,34522,7.8,DE
75,2011,Apr,62.4,57.6,442904,408731,34173,7.7,DE
76,2011,May,62.4,57.6,443006,408994,34012,7.7,DE
77,2011,Jun,62.3,57.6,443112,409159,33953,7.7,DE
78,2011,Jul,62.3,57.6,443468,409601,33867,7.6,DE
79,2011,Aug,62.3,57.6,444138,410471,33667,7.6,DE
80,2011,Sep,62.4,57.7,444928,411634,33294,7.5,DE
81,2011,Oct,62.4,57.8,445636,412856,32780,7.4,DE
82,2011,Nov,62.4,57.9,446063,413853,32210,7.2,DE
83,2011,Dec,62.4,58.0,446201,414510,31691,7.1,DE
84,2012,Jan,62.3,58.0,446183,414872,31311,7.0,DE
85,2012,Feb,62.3,57.9,446164,415034,31130,7.0,DE
86,2012,Mar,62.2,57.9,446185,414992,31193,7.0,DE
87,2012,Apr,62.2,57.8,446181,414769,31412,7.0,DE
88,2012,May,62.1,57.7,446177,414524,31653,7.1,DE
89,2012,Jun,62.1,57.7,446176,414378,31798,7.1,DE
90,2012,Jul,62.0,57.6,446132,414347,31785,7.1,DE
91,2012,Aug,62.0,57.6,446071,414386,31685,7.1,DE
92,2012,Sep,61.9,57.5,446070,414465,31605,7.1,DE
93,2012,Oct,61.8,57.4,446007,414443,31564,7.1,DE
94,2012,Nov,61.7,57.3,445776,414226,31550,7.1,DE
95,2012,Dec,61.6,57.2,445343,413820,31523,7.1,DE
96,2013,Jan,61.4,57.1,444691,413236,31455,7.1,DE
97,2013,Feb,61.3,57.0,443906,412611,31295,7.0,DE
98,2013,Mar,61.1,56.9,443158,412171,30987,7.0,DE
99,2013,Apr,61.0,56.8,442681,412135,30546,6.9,DE
100,2013,May,60.9,56.8,442526,412480,30046,6.8,DE
101,2013,Jun,60.9,56.8,442641,413085,29556,6.7,DE
102,2013,Jul,60.9,56.9,442935,413831,29104,6.6,DE
103,2013,Aug,60.8,56.9,443283,414660,28623,6.5,DE
104,2013,Sep,60.8,57.0,443676,415572,28104,6.3,DE
105,2013,Oct,60.8,57.0,444215,416563,27652,6.2,DE
106,2013,Nov,60.8,57.1,444909,417594,27315,6.1,DE
107,2013,Dec,60.9,57.2,445675,418596,27079,6.1,DE
108,2014,Jan,60.9,57.3,446546,419663,26883,6.0,DE
109,2014,Feb,61.0,57.4,447591,420921,26670,6.0,DE
110,2014,Mar,61.1,57.5,448826,422367,26459,5.9,DE
111,2014,Apr,61.2,57.7,450102,423844,26258,5.8,DE
112,2014,May,61.3,57.8,451305,425282,26023,5.8,DE
113,2014,Jun,61.4,57.9,452472,426731,25741,5.7,DE
114,2014,Jul,61.5,58.1,453608,428207,25401,5.6,DE
115,2014,Aug,61.6,58.2,454713,429692,25021,5.5,DE
116,2014,Sep,61.7,58.3,455690,431084,24606,5.4,DE
117,2014,Oct,61.7,58.4,456448,432329,24119,5.3,DE
118,2014,Nov,61.7,58.5,457025,433436,23589,5.2,DE
119,2014,Dec,61.7,58.6,457575,434437,23138,5.1,DE
120,2015,Jan,61.7,58.7,458168,435330,22838,5.0,DE
121,2015,Feb,61.8,58.7,458835,436141,22694,4.9,DE
122,2015,Mar,61.8,58.8,459628,437007,22621,4.9,DE
123,2015,Apr,61.9,58.9,460528,437998,22530,4.9,DE
124,2015,May,62.0,58.9,461456,439061,22395,4.9,DE
125,2015,Jun,62.0,59.0,462330,440105,22225,4.8,DE
126,2015,Jul,62.1,59.1,463176,441109,22067,4.8,DE
127,2015,Aug,62.1,59.2,464036,442091,21945,4.7,DE
128,2015,Sep,62.2,59.2,464940,443116,21824,4.7,DE
129,2015,Oct,62.2,59.3,465959,444262,21697,4.7,DE
130,2015,Nov,62.3,59.4,467051,445489,21562,4.6,DE
131,2015,Dec,62.4,59.6,468016,446642,21374,4.6,DE
132,2016,Jan,62.4,59.6,468654,447512,21142,4.5,DE
133,2016,Feb,62.4,59.6,468905,447972,20933,4.5,DE
134,2016,Mar,62.4,59.6,468851,448073,20778,4.4,DE
135,2016,Apr,62.3,59.5,468680,447969,20711,4.4,DE
136,2016,May,62.2,59.5,468563,447804,20759,4.4,DE
137,2016,Jun,62.1,59.4,468515,447619,20896,4.5,DE
138,2016,Jul,62.1,59.3,468517,447440,21077,4.5,DE
139,2016,Aug,62.0,59.2,468615,447331,21284,4.5,DE
140,2016,Sep,62.0,59.2,468865,447328,21537,4.6,DE
141,2016,Oct,62.0,59.1,469237,447444,21793,4.6,DE
142,2016,Nov,62.0,59.1,469756,447782,21974,4.7,DE
143,2016,Dec,62.0,59.1,470473,448430,22043,4.7,DE
144,2017,Jan,61.9,59.0,470994,448971,22023,4.7,DE
145,2017,Feb,62.0,59.2,472026,450089,21937,4.6,DE
146,2017,Mar,62.1,59.2,472954,451138,21816,4.6,DE
147,2017,Apr,62.2,59.3,473834,452145,21689,4.6,DE
148,2017,May,62.2,59.4,474720,453188,21532,4.5,DE
149,2017,Jun,62.3,59.5,475584,454216,21368,4.5,DE
150,2017,Jul,62.3,59.6,476348,455117,21231,4.5,DE
151,2017,Aug,62.3,59.6,476879,455788,21091,4.4,DE
152,2017,Sep,62.3,59.6,477134,456213,20921,4.4,DE
153,2017,Oct,62.2,59.5,477200,456491,20709,4.3,DE
154,2017,Nov,62.2,59.5,477198,456726,20472,4.3,DE
155,2017,Dec,62.1,59.5,477330,457153,20177,4.2,DE
156,2018,Jan,62.1,59.6,477849,458014,19835,4.2,DE
157,2018,Feb,62.2,59.7,478859,459386,19473,4.1,DE
158,2018,Mar,62.3,59.9,480089,460998,19091,4.0,DE
159,2018,Apr,62.4,60.0,480979,462285,18694,3.9,DE
160,2018,May,62.4,60.0,481216,462907,18309,3.8,DE
161,2018,Jun,62.3,59.9,480865,462940,17925,3.7,DE
162,2018,Jul,62.1,59.8,480159,462621,17538,3.7,DE
163,2018,Aug,62.0,59.7,479524,462295,17229,3.6,DE
164,2018,Sep,61.8,59.6,479275,462222,17053,3.6,DE
165,2018,Oct,61.8,59.6,479610,462589,17021,3.5,DE
166,2018,Nov,61.9,59.7,480528,463425,17103,3.6,DE
167,2018,Dec,62.0,59.8,481810,464564,17246,3.6,DE
168,2019,Jan,62.1,59.8,483050,465661,17389,3.6,DE
169,2019,Feb,62.1,59.9,483986,466519,17467,3.6,DE
170,2019,Mar,62.2,59.9,484650,467121,17529,3.6,DE
171,2019,Apr,62.2,59.9,485166,467549,17617,3.6,DE
172,2019,May,62.2,59.9,485535,467771,17764,3.7,DE
173,2019,Jun,62.1,59.8,485753,467750,18003,3.7,DE
174,2019,Jul,62.1,59.7,485817,467528,18289,3.8,DE
175,2019,Aug,62.0,59.6,485664,467154,18510,3.8,DE
176,2019,Sep,61.8,59.5,485367,466833,18534,3.8,DE
177,2019,Oct,61.7,59.4,484936,466554,18382,3.8,DE
178,2019,Nov,61.5,59.2,484264,466144,18120,3.7,DE
179,2019,Dec,61.3,59.1,483225,465364,17861,3.7,DE
180,2020,Jan,61.1,58.8,481858,464181,17677,3.7,DE
181,2020,Feb,60.8,58.6,480278,462670,17608,3.7,DE
182,2020,Mar,61.4,58.4,485567,461203,24364,5.0,DE
183,2020,Apr,59.4,51.6,469927,408576,61351,13.1,DE
184,2020,May,62.3,54.0,493333,427718,65615,13.3,DE
185,2020,Jun,63.0,54.9,498903,435415,63488,12.7,DE
186,2020,Jul,60.5,55.8,480071,443036,37035,7.7,DE
187,2020,Aug,61.2,56.6,485993,449462,36531,7.5,DE
188,2020,Sep,61.9,57.2,492248,454710,37538,7.6,DE
189,2020,Oct,60.8,57.5,484017,458270,25747,5.3,DE
190,2020,Nov,61.1,57.8,487151,460683,26468,5.4,DE
191,2020,Dec,61.3,57.9,489824,462330,27494,5.6,DE
192,2021,Jan,61.5,58.0,491572,463734,27838,5.7,DE
193,2021,Feb,61.7,58.1,493461,465258,28203,5.7,DE
194,2021,Mar,61.9,58.3,495500,466961,28539,5.8,DE
195,2021,Apr,62.0,58.4,497115,468513,28602,5.8,DE
196,2021,May,62.0,58.5,497969,469655,28314,5.7,DE
197,2021,Jun,62.0,58.5,498444,470208,28236,5.7,DE
198,2021,Jul,61.8,58.4,497824,470555,27269,5.5,DE
199,2021,Aug,61.7,58.4,497316,470934,26382,5.3,DE
200,2021,Sep,61.5,58.4,496543,471594,24949,5.0,DE
201,2021,Oct,61.4,58.4,496684,472408,24276,4.9,DE
202,2021,Nov,61.3,58.4,496766,472885,23881,4.8,DE
203,2021,Dec,61.2,58.3,497019,473079,23940,4.8,DE
204,2022,Jan,61.3,58.4,498190,474337,23853,4.8,DE
205,2022,Feb,61.2,58.4,498219,475214,23005,4.6,DE
206,2022,Mar,61.2,58.4,498591,476005,22586,4.5,DE
207,2022,Apr,61.2,58.4,498950,476510,22440,4.5,DE
208,2022,May,61.2,58.4,500101,477480,22621,4.5,DE
209,2022,Jun,61.2,58.4,500430,477734,22696,4.5,DE
210,2022,Jul,61.1,58.4,500469,478257,22212,4.4,DE
211,2022,Aug,61.0,58.3,500666,478335,22331,4.5,DE
212,2022,Sep,60.8,58.2,500137,478856,21281,4.3,DE
213,2022,Oct,60.7,58.1,500006,478336,21670,4.3,DE
214,2022,Nov,60.5,57.8,498713,476957,21756,4.4,DE
0,2005,Jan,71.7,66.6,341438,317165,24273,7.1,AK
1,2005,Feb,71.7,66.7,341972,317924,24048,7.0,AK
2,2005,Mar,71.7,66.8,342453,318673,23780,6.9,AK
3,2005,Apr,71.7,66.8,342940,319427,23513,6.9,AK
4,2005,May,71.7,66.9,343476,320167,23309,6.8,AK
5,2005,Jun,71.7,66.9,344040,320787,23253,6.8,AK
6,2005,Jul,71.7,66.9,344616,321214,23402,6.8,AK
7,2005,Aug,71.7,66.8,345128,321428,23700,6.9,AK
8,2005,Sep,71.7,66.7,345532,321504,24028,7.0,AK
9,2005,Oct,71.6,66.5,345831,321576,24255,7.0,AK
10,2005,Nov,71.5,66.4,346027,321695,24332,7.0,AK
11,2005,Dec,71.4,66.4,346169,321902,24267,7.0,AK
12,2006,Jan,71.3,66.3,346388,322315,24073,6.9,AK
13,2006,Feb,71.2,66.3,346742,322936,23806,6.9,AK
14,2006,Mar,71.2,66.4,347278,323717,23561,6.8,AK
15,2006,Apr,71.2,66.4,347940,324533,23407,6.7,AK
16,2006,May,71.2,66.5,348562,325248,23314,6.7,AK
17,2006,Jun,71.2,66.5,349037,325825,23212,6.7,AK
18,2006,Jul,71.2,66.5,349357,326290,23067,6.6,AK
19,2006,Aug,71.2,66.5,349634,326706,22928,6.6,AK
20,2006,Sep,71.1,66.5,349874,327071,22803,6.5,AK
21,2006,Oct,71.1,66.5,350052,327406,22646,6.5,AK
22,2006,Nov,71.1,66.5,350202,327755,22447,6.4,AK
23,2006,Dec,71.0,66.5,350246,328038,22208,6.3,AK
24,2007,Jan,70.9,66.5,350083,328102,21981,6.3,AK
25,2007,Feb,70.8,66.4,349811,327999,21812,6.2,AK
26,2007,Mar,70.7,66.3,349471,327774,21697,6.2,AK
27,2007,Apr,70.6,66.2,349168,327497,21671,6.2,AK
28,2007,May,70.5,66.1,349067,327322,21745,6.2,AK
29,2007,Jun,70.5,66.0,349218,327344,21874,6.3,AK
30,2007,Jul,70.5,66.0,349601,327600,22001,6.3,AK
31,2007,Aug,70.5,66.1,350146,328057,22089,6.3,AK
32,2007,Sep,70.6,66.1,350731,328614,22117,6.3,AK
33,2007,Oct,70.6,66.2,351277,329175,22102,6.3,AK
34,2007,Nov,70.6,66.2,351710,329677,22033,6.3,AK
35,2007,Dec,70.7,66.3,352134,330190,21944,6.2,AK
36,2008,Jan,70.7,66.3,352640,330728,21912,6.2,AK
37,2008,Feb,70.8,66.4,353200,331231,21969,6.2,AK
38,2008,Mar,70.9,66.4,353867,331722,22145,6.3,AK
39,2008,Apr,71.0,66.5,354642,332225,22417,6.3,AK
40,2008,May,71.0,66.5,355376,332635,22741,6.4,AK
41,2008,Jun,71.1,66.5,355922,332865,23057,6.5,AK
42,2008,Jul,71.1,66.4,356199,332941,23258,6.5,AK
43,2008,Aug,70.9,66.3,356256,332935,23321,6.5,AK
44,2008,Sep,70.8,66.2,356278,332909,23369,6.6,AK
45,2008,Oct,70.7,66.0,356381,332820,23561,6.6,AK
46,2008,Nov,70.6,65.8,356617,332618,23999,6.7,AK
47,2008,Dec,70.5,65.6,357004,332312,24692,6.9,AK
48,2009,Jan,70.5,65.4,357527,331939,25588,7.2,AK
49,2009,Feb,70.5,65.2,358159,331565,26594,7.4,AK
50,2009,Mar,70.5,65.0,358815,331287,27528,7.7,AK
51,2009,Apr,70.4,64.9,359404,331163,28241,7.9,AK
52,2009,May,70.4,64.8,359892,331161,28731,8.0,AK
53,2009,Jun,70.3,64.6,360268,331193,29075,8.1,AK
54,2009,Jul,70.2,64.5,360424,331095,29329,8.1,AK
55,2009,Aug,70.1,64.4,360299,330803,29496,8.2,AK
56,2009,Sep,70.1,64.3,360018,330431,29587,8.2,AK
57,2009,Oct,70.0,64.2,359711,330034,29677,8.3,AK
58,2009,Nov,69.9,64.1,359647,329798,29849,8.3,AK
59,2009,Dec,70.0,64.1,359932,329829,30103,8.4,AK
60,2010,Jan,70.0,64.1,360431,330113,30318,8.4,AK
61,2010,Feb,70.1,64.2,360957,330579,30378,8.4,AK
62,2010,Mar,70.2,64.3,361357,331099,30258,8.4,AK
63,2010,Apr,70.1,64.3,361538,331564,29974,8.3,AK
64,2010,May,70.0,64.2,361511,331982,29529,8.2,AK
65,2010,Jun,69.8,64.2,361350,332315,29035,8.0,AK
66,2010,Jul,69.6,64.1,361237,332532,28705,7.9,AK
67,2010,Aug,69.5,64.0,361349,332690,28659,7.9,AK
68,2010,Sep,69.5,63.9,361682,332846,28836,8.0,AK
69,2010,Oct,69.4,63.9,362226,333152,29074,8.0,AK
70,2010,Nov,69.4,63.8,362765,333546,29219,8.1,AK
71,2010,Dec,69.3,63.8,363140,333936,29204,8.0,AK
72,2011,Jan,69.3,63.8,363404,334356,29048,8.0,AK
73,2011,Feb,69.2,63.7,363514,334711,28803,7.9,AK
74,2011,Mar,69.1,63.7,363451,334935,28516,7.8,AK
75,2011,Apr,69.0,63.6,363367,335095,28272,7.8,AK
76,2011,May,68.9,63.6,363406,335267,28139,7.7,AK
77,2011,Jun,68.8,63.5,363679,335579,28100,7.7,AK
78,2011,Jul,68.8,63.5,364268,336147,28121,7.7,AK
79,2011,Aug,68.9,63.6,365018,336857,28161,7.7,AK
80,2011,Sep,68.9,63.6,365643,337487,28156,7.7,AK
81,2011,Oct,68.9,63.6,365963,337901,28062,7.7,AK
82,2011,Nov,68.8,63.6,365959,338096,27863,7.6,AK
83,2011,Dec,68.7,63.5,365671,338095,27576,7.5,AK
84,2012,Jan,68.6,63.5,365200,337946,27254,7.5,AK
85,2012,Feb,68.4,63.4,364748,337774,26974,7.4,AK
86,2012,Mar,68.3,63.3,364426,337625,26801,7.4,AK
87,2012,Apr,68.2,63.2,364174,337455,26719,7.3,AK
88,2012,May,68.1,63.1,364032,337365,26667,7.3,AK
89,2012,Jun,68.0,63.1,363960,337406,26554,7.3,AK
90,2012,Jul,67.9,63.0,363887,337576,26311,7.2,AK
91,2012,Aug,67.9,63.0,363879,337853,26026,7.2,AK
92,2012,Sep,67.9,63.1,364057,338216,25841,7.1,AK
93,2012,Oct,67.9,63.1,364283,338526,25757,7.1,AK
94,2012,Nov,67.9,63.1,364384,338657,25727,7.1,AK
95,2012,Dec,67.8,63.0,364287,338581,25706,7.1,AK
96,2013,Jan,67.7,63.0,364023,338344,25679,7.1,AK
97,2013,Feb,67.7,62.9,363684,338057,25627,7.0,AK
98,2013,Mar,67.6,62.8,363411,337876,25535,7.0,AK
99,2013,Apr,67.6,62.8,363341,337923,25418,7.0,AK
100,2013,May,67.5,62.8,363431,338083,25348,7.0,AK
101,2013,Jun,67.6,62.8,363613,338220,25393,7.0,AK
102,2013,Jul,67.5,62.8,363803,338308,25495,7.0,AK
103,2013,Aug,67.5,62.8,363845,338340,25505,7.0,AK
104,2013,Sep,67.5,62.7,363710,338320,25390,7.0,AK
105,2013,Oct,67.4,62.7,363558,338279,25279,7.0,AK
106,2013,Nov,67.4,62.7,363547,338306,25241,6.9,AK
107,2013,Dec,67.4,62.7,363695,338449,25246,6.9,AK
108,2014,Jan,67.4,62.8,363966,338735,25231,6.9,AK
109,2014,Feb,67.5,62.9,364333,339157,25176,6.9,AK
110,2014,Mar,67.6,62.9,364723,339585,25138,6.9,AK
111,2014,Apr,67.6,62.9,364982,339829,25153,6.9,AK
112,2014,May,67.6,62.9,365047,339891,25156,6.9,AK
113,2014,Jun,67.6,62.9,364977,339893,25084,6.9,AK
114,2014,Jul,67.5,62.9,364744,339820,24924,6.8,AK
115,2014,Aug,67.4,62.9,364445,339777,24668,6.8,AK
116,2014,Sep,67.3,62.8,364135,339845,24290,6.7,AK
117,2014,Oct,67.2,62.8,363829,340035,23794,6.5,AK
118,2014,Nov,67.2,62.9,363530,340262,23268,6.4,AK
119,2014,Dec,67.1,62.9,363338,340470,22868,6.3,AK
120,2015,Jan,67.1,62.9,363226,340538,22688,6.2,AK
121,2015,Feb,67.0,62.8,363134,340415,22719,6.3,AK
122,2015,Mar,67.0,62.8,363053,340222,22831,6.3,AK
123,2015,Apr,67.0,62.8,362975,340096,22879,6.3,AK
124,2015,May,66.9,62.7,362798,339977,22821,6.3,AK
125,2015,Jun,66.8,62.7,362477,339787,22690,6.3,AK
126,2015,Jul,66.8,62.6,362134,339558,22576,6.2,AK
127,2015,Aug,66.6,62.5,361851,339307,22544,6.2,AK
128,2015,Sep,66.6,62.4,361622,339036,22586,6.2,AK
129,2015,Oct,66.5,62.3,361498,338801,22697,6.3,AK
130,2015,Nov,66.4,62.2,361518,338641,22877,6.3,AK
131,2015,Dec,66.4,62.2,361660,338572,23088,6.4,AK
132,2016,Jan,66.4,62.1,361853,338581,23272,6.4,AK
133,2016,Feb,66.4,62.1,362043,338619,23424,6.5,AK
134,2016,Mar,66.4,62.1,362120,338578,23542,6.5,AK
135,2016,Apr,66.3,62.0,362119,338457,23662,6.5,AK
136,2016,May,66.3,61.9,362119,338314,23805,6.6,AK
137,2016,Jun,66.2,61.9,362098,338159,23939,6.6,AK
138,2016,Jul,66.2,61.8,362029,338000,24029,6.6,AK
139,2016,Aug,66.1,61.7,361944,337853,24091,6.7,AK
140,2016,Sep,66.1,61.7,361974,337799,24175,6.7,AK
141,2016,Oct,66.2,61.7,362112,337870,24242,6.7,AK
142,2016,Nov,66.2,61.7,362298,338067,24231,6.7,AK
143,2016,Dec,66.2,61.8,362459,338328,24131,6.7,AK
144,2017,Jan,66.2,61.8,361868,337962,23906,6.6,AK
145,2017,Feb,66.2,61.9,361924,338214,23710,6.6,AK
146,2017,Mar,66.2,61.9,361919,338359,23560,6.5,AK
147,2017,Apr,66.2,61.9,361816,338325,23491,6.5,AK
148,2017,May,66.2,61.9,361601,338131,23470,6.5,AK
149,2017,Jun,66.1,61.8,361303,337822,23481,6.5,AK
150,2017,Jul,66.1,61.7,360916,337403,23513,6.5,AK
151,2017,Aug,66.0,61.6,360404,336888,23516,6.5,AK
152,2017,Sep,65.8,61.5,359766,336298,23468,6.5,AK
153,2017,Oct,65.7,61.4,359052,335702,23350,6.5,AK
154,2017,Nov,65.6,61.3,358314,335142,23172,6.5,AK
155,2017,Dec,65.5,61.3,357632,334722,22910,6.4,AK
156,2018,Jan,65.4,61.2,357116,334533,22583,6.3,AK
157,2018,Feb,65.3,61.3,356817,334598,22219,6.2,AK
158,2018,Mar,65.3,61.3,356698,334855,21843,6.1,AK
159,2018,Apr,65.3,61.4,356583,335100,21483,6.0,AK
160,2018,May,65.3,61.4,356371,335170,21201,5.9,AK
161,2018,Jun,65.2,61.4,356039,335039,21000,5.9,AK
162,2018,Jul,65.2,61.4,355570,334734,20836,5.9,AK
163,2018,Aug,65.1,61.3,355011,334274,20737,5.8,AK
164,2018,Sep,65.0,61.2,354415,333683,20732,5.8,AK
165,2018,Oct,64.9,61.1,353898,333099,20799,5.9,AK
166,2018,Nov,64.8,61.0,353491,332641,20850,5.9,AK
167,2018,Dec,64.7,60.9,353132,332359,20773,5.9,AK
168,2019,Jan,64.7,60.9,352773,332247,20526,5.8,AK
169,2019,Feb,64.7,61.0,352506,332380,20126,5.7,AK
170,2019,Mar,64.7,61.0,352420,332710,19710,5.6,AK
171,2019,Apr,64.7,61.1,352608,333202,19406,5.5,AK
172,2019,May,64.8,61.2,352970,333694,19276,5.5,AK
173,2019,Jun,64.8,61.3,353298,334000,19298,5.5,AK
174,2019,Jul,64.9,61.3,353465,334072,19393,5.5,AK
175,2019,Aug,64.9,61.3,353418,334011,19407,5.5,AK
176,2019,Sep,64.8,61.3,353184,334025,19159,5.4,AK
177,2019,Oct,64.8,61.3,352902,334144,18758,5.3,AK
178,2019,Nov,64.7,61.4,352760,334362,18398,5.2,AK
179,2019,Dec,64.7,61.4,352695,334486,18209,5.2,AK
180,2020,Jan,64.7,61.4,352483,334287,18196,5.2,AK
181,2020,Feb,64.6,61.3,351886,333653,18233,5.2,AK
182,2020,Mar,64.5,61.1,350910,332823,18087,5.2,AK
183,2020,Apr,62.0,54.7,337566,297482,40084,11.9,AK
184,2020,May,63.5,55.9,345436,304260,41176,11.9,AK
185,2020,Jun,63.7,56.5,346513,307304,39209,11.3,AK
186,2020,Jul,64.4,57.2,350100,310952,39148,11.2,AK
187,2020,Aug,62.7,57.8,340991,314304,26687,7.8,AK
188,2020,Sep,63.2,58.3,344056,317552,26504,7.7,AK
189,2020,Oct,63.4,58.8,345258,319963,25295,7.3,AK
190,2020,Nov,63.7,59.1,346817,321790,25027,7.2,AK
191,2020,Dec,64.0,59.3,348591,323188,25403,7.3,AK
192,2021,Jan,64.1,59.5,349154,324408,24746,7.1,AK
193,2021,Feb,64.3,59.8,350283,325614,24669,7.0,AK
194,2021,Mar,64.5,60.0,351509,326831,24678,7.0,AK
195,2021,Apr,64.7,60.2,352838,327977,24861,7.0,AK
196,2021,May,64.8,60.4,353153,329080,24073,6.8,AK
197,2021,Jun,65.0,60.6,354556,330283,24273,6.8,AK
198,2021,Jul,65.0,60.8,354921,331906,23015,6.5,AK
199,2021,Aug,65.2,61.2,356195,333889,22306,6.3,AK
200,2021,Sep,65.3,61.5,356963,336071,20892,5.9,AK
201,2021,Oct,65.6,61.9,358558,338075,20483,5.7,AK
202,2021,Nov,65.6,62.0,358735,338940,19795,5.5,AK
203,2021,Dec,65.6,62.0,358991,339274,19717,5.5,AK
204,2022,Jan,66.0,62.3,361049,340980,20069,5.6,AK
205,2022,Feb,66.1,62.5,361562,342319,19243,5.3,AK
206,2022,Mar,66.0,62.8,361580,343689,17891,4.9,AK
207,2022,Apr,66.1,62.9,361817,344375,17442,4.8,AK
208,2022,May,66.2,63.1,362486,345690,16796,4.6,AK
209,2022,Jun,66.1,63.1,362564,346021,16543,4.6,AK
210,2022,Jul,66.0,63.0,361861,345562,16299,4.5,AK
211,2022,Aug,65.9,62.9,361918,345257,16661,4.6,AK
212,2022,Sep,65.7,62.8,360657,344799,15858,4.4,AK
213,2022,Oct,65.6,62.7,360474,344277,16197,4.5,AK
214,2022,Nov,65.5,62.5,359888,343737,16151,4.5,AK
0,2005,Jan,62.9,59.5,1320144,1248822,71322,5.4,AR
1,2005,Feb,62.9,59.6,1323041,1252355,70686,5.3,AR
2,2005,Mar,63.0,59.7,1325810,1255998,69812,5.3,AR
3,2005,Apr,63.1,59.8,1328586,1259507,69079,5.2,AR
4,2005,May,63.2,59.9,1331576,1262763,68813,5.2,AR
5,2005,Jun,63.3,60.0,1334725,1265578,69147,5.2,AR
6,2005,Jul,63.3,60.0,1337609,1267612,69997,5.2,AR
7,2005,Aug,63.3,60.0,1339765,1268919,70846,5.3,AR
8,2005,Sep,63.2,59.8,1341047,1269841,71206,5.3,AR
9,2005,Oct,63.2,59.9,1341579,1270710,70869,5.3,AR
10,2005,Nov,63.1,59.8,1341840,1271732,70108,5.2,AR
11,2005,Dec,63.1,59.8,1342120,1272820,69300,5.2,AR
12,2006,Jan,63.0,59.8,1342700,1273915,68785,5.1,AR
13,2006,Feb,63.0,59.8,1343722,1274911,68811,5.1,AR
14,2006,Mar,63.0,59.8,1345046,1275609,69437,5.2,AR
15,2006,Apr,63.0,59.7,1346255,1275834,70421,5.2,AR
16,2006,May,62.9,59.6,1346847,1275583,71264,5.3,AR
17,2006,Jun,62.9,59.5,1346705,1274991,71714,5.3,AR
18,2006,Jul,62.8,59.4,1346289,1274581,71708,5.3,AR
19,2006,Aug,62.7,59.4,1346217,1274701,71516,5.3,AR
20,2006,Sep,62.7,59.4,1346678,1275263,71415,5.3,AR
21,2006,Oct,62.7,59.3,1347720,1276360,71360,5.3,AR
22,2006,Nov,62.7,59.4,1349135,1277814,71321,5.3,AR
23,2006,Dec,62.7,59.4,1350471,1279168,71303,5.3,AR
24,2007,Jan,62.7,59.4,1351331,1279989,71342,5.3,AR
25,2007,Feb,62.6,59.3,1351478,1279970,71508,5.3,AR
26,2007,Mar,62.6,59.2,1350887,1279107,71780,5.3,AR
27,2007,Apr,62.5,59.1,1349996,1277800,72196,5.3,AR
28,2007,May,62.4,59.0,1349262,1276423,72839,5.4,AR
29,2007,Jun,62.3,58.9,1348840,1275317,73523,5.5,AR
30,2007,Jul,62.2,58.8,1348878,1274796,74082,5.5,AR
31,2007,Aug,62.2,58.8,1349562,1275104,74458,5.5,AR
32,2007,Sep,62.2,58.8,1350759,1276385,74374,5.5,AR
33,2007,Oct,62.2,58.8,1352032,1278323,73709,5.5,AR
34,2007,Nov,62.2,58.9,1352941,1280515,72426,5.4,AR
35,2007,Dec,62.2,58.9,1353447,1282727,70720,5.2,AR
36,2008,Jan,62.2,59.0,1353678,1284620,69058,5.1,AR
37,2008,Feb,62.1,59.0,1353823,1286093,67730,5.0,AR
38,2008,Mar,62.1,59.0,1354111,1287098,67013,4.9,AR
39,2008,Apr,62.1,59.0,1354740,1287626,67114,5.0,AR
40,2008,May,62.1,59.0,1355970,1287961,68009,5.0,AR
41,2008,Jun,62.1,58.9,1357843,1288251,69592,5.1,AR
42,2008,Jul,62.2,58.9,1359733,1288132,71601,5.3,AR
43,2008,Aug,62.2,58.8,1360944,1287008,73936,5.4,AR
44,2008,Sep,62.2,58.6,1361416,1284515,76901,5.6,AR
45,2008,Oct,62.1,58.4,1361363,1280596,80767,5.9,AR
46,2008,Nov,62.0,58.2,1361045,1275604,85441,6.3,AR
47,2008,Dec,62.0,57.9,1360662,1270115,90547,6.7,AR
48,2009,Jan,61.9,57.6,1360180,1264593,95587,7.0,AR
49,2009,Feb,61.9,57.3,1359814,1259658,100156,7.4,AR
50,2009,Mar,61.8,57.1,1359655,1255912,103743,7.6,AR
51,2009,Apr,61.8,57.0,1359293,1253369,105924,7.8,AR
52,2009,May,61.7,56.9,1358162,1251338,106824,7.9,AR
53,2009,Jun,61.6,56.7,1356219,1249384,106835,7.9,AR
54,2009,Jul,61.4,56.6,1353772,1247347,106425,7.9,AR
55,2009,Aug,61.3,56.5,1351081,1245167,105914,7.8,AR
56,2009,Sep,61.1,56.3,1348368,1242864,105504,7.8,AR
57,2009,Oct,60.9,56.1,1345775,1240400,105375,7.8,AR
58,2009,Nov,60.8,56.0,1343857,1238191,105666,7.9,AR
59,2009,Dec,60.7,55.9,1343147,1236853,106294,7.9,AR
60,2010,Jan,60.7,55.9,1343957,1237151,106806,7.9,AR
61,2010,Feb,60.8,55.9,1345947,1239114,106833,7.9,AR
62,2010,Mar,60.9,56.1,1348707,1242264,106443,7.9,AR
63,2010,Apr,60.6,55.8,1351964,1246062,105902,7.8,AR
64,2010,May,60.7,56.0,1355055,1249752,105303,7.8,AR
65,2010,Jun,60.7,56.0,1357180,1252284,104896,7.7,AR
66,2010,Jul,60.7,56.0,1358003,1253026,104977,7.7,AR
67,2010,Aug,60.6,55.9,1357870,1252260,105610,7.8,AR
68,2010,Sep,60.6,55.8,1357262,1250630,106632,7.9,AR
69,2010,Oct,60.5,55.7,1356803,1249134,107669,7.9,AR
70,2010,Nov,60.5,55.6,1356630,1248235,108395,8.0,AR
71,2010,Dec,60.4,55.6,1356570,1247898,108672,8.0,AR
72,2011,Jan,60.4,55.5,1356376,1247709,108667,8.0,AR
73,2011,Feb,60.3,55.5,1355709,1247149,108560,8.0,AR
74,2011,Mar,60.2,55.4,1354508,1246167,108341,8.0,AR
75,2011,Apr,60.1,55.3,1353056,1244909,108147,8.0,AR
76,2011,May,60.0,55.2,1352224,1244047,108177,8.0,AR
77,2011,Jun,60.0,55.2,1352740,1244430,108310,8.0,AR
78,2011,Jul,60.1,55.3,1354815,1246487,108328,8.0,AR
79,2011,Aug,60.2,55.4,1357919,1249882,108037,8.0,AR
80,2011,Sep,60.3,55.5,1361072,1253820,107252,7.9,AR
81,2011,Oct,60.4,55.7,1363485,1257461,106024,7.8,AR
82,2011,Nov,60.4,55.8,1364537,1260075,104462,7.7,AR
83,2011,Dec,60.3,55.8,1364056,1261291,102765,7.5,AR
84,2012,Jan,60.2,55.8,1362428,1261262,101166,7.4,AR
85,2012,Feb,60.1,55.7,1360339,1260404,99935,7.3,AR
86,2012,Mar,60.0,55.6,1358109,1258810,99299,7.3,AR
87,2012,Apr,59.9,55.5,1355831,1256764,99067,7.3,AR
88,2012,May,59.8,55.4,1353594,1254657,98937,7.3,AR
89,2012,Jun,59.6,55.3,1351226,1252563,98663,7.3,AR
90,2012,Jul,59.5,55.2,1348643,1250599,98044,7.3,AR
91,2012,Aug,59.3,55.1,1346157,1248907,97250,7.2,AR
92,2012,Sep,59.2,55.0,1344172,1247567,96605,7.2,AR
93,2012,Oct,59.1,54.9,1342472,1246289,96183,7.2,AR
94,2012,Nov,59.0,54.8,1340897,1244873,96024,7.2,AR
95,2012,Dec,58.9,54.7,1339452,1243386,96066,7.2,AR
96,2013,Jan,58.9,54.6,1338053,1241811,96242,7.2,AR
97,2013,Feb,58.8,54.6,1336764,1240366,96398,7.2,AR
98,2013,Mar,58.7,54.5,1335682,1239345,96337,7.2,AR
99,2013,Apr,58.7,54.5,1334874,1238821,96053,7.2,AR
100,2013,May,58.6,54.4,1334104,1238431,95673,7.2,AR
101,2013,Jun,58.6,54.4,1333280,1237985,95295,7.1,AR
102,2013,Jul,58.5,54.3,1332281,1237390,94891,7.1,AR
103,2013,Aug,58.4,54.3,1330709,1236614,94095,7.1,AR
104,2013,Sep,58.3,54.2,1328616,1235898,92718,7.0,AR
105,2013,Oct,58.2,54.2,1326715,1235660,91055,6.9,AR
106,2013,Nov,58.1,54.2,1325461,1236175,89286,6.7,AR
107,2013,Dec,58.1,54.2,1324767,1237331,87436,6.6,AR
108,2014,Jan,58.0,54.3,1324443,1238994,85449,6.5,AR
109,2014,Feb,58.0,54.4,1324270,1240888,83382,6.3,AR
110,2014,Mar,58.0,54.4,1324213,1242674,81539,6.2,AR
111,2014,Apr,58.0,54.5,1324212,1244129,80083,6.0,AR
112,2014,May,58.0,54.5,1324336,1245446,78890,6.0,AR
113,2014,Jun,58.0,54.6,1324928,1247064,77864,5.9,AR
114,2014,Jul,58.0,54.6,1326166,1249184,76982,5.8,AR
115,2014,Aug,58.0,54.7,1328224,1251928,76296,5.7,AR
116,2014,Sep,58.1,54.8,1330805,1255079,75726,5.7,AR
117,2014,Oct,58.2,54.9,1333104,1258078,75026,5.6,AR
118,2014,Nov,58.2,55.0,1334565,1260362,74203,5.6,AR
119,2014,Dec,58.2,55.0,1335449,1261924,73525,5.5,AR
120,2015,Jan,58.2,55.1,1336169,1263086,73083,5.5,AR
121,2015,Feb,58.3,55.1,1336952,1264167,72785,5.4,AR
122,2015,Mar,58.3,55.1,1337920,1265637,72283,5.4,AR
123,2015,Apr,58.3,55.2,1338983,1267673,71310,5.3,AR
124,2015,May,58.3,55.3,1339839,1269993,69846,5.2,AR
125,2015,Jun,58.3,55.4,1340124,1272125,67999,5.1,AR
126,2015,Jul,58.3,55.4,1339927,1273942,65985,4.9,AR
127,2015,Aug,58.2,55.4,1339528,1275545,63983,4.8,AR
128,2015,Sep,58.2,55.5,1339273,1277195,62078,4.6,AR
129,2015,Oct,58.2,55.6,1339813,1279410,60403,4.5,AR
130,2015,Nov,58.2,55.7,1341300,1282346,58954,4.4,AR
131,2015,Dec,58.3,55.8,1343071,1285465,57606,4.3,AR
132,2016,Jan,58.3,55.9,1344484,1288132,56352,4.2,AR
133,2016,Feb,58.3,55.9,1345263,1289972,55291,4.1,AR
134,2016,Mar,58.3,55.9,1345319,1290874,54445,4.0,AR
135,2016,Apr,58.2,55.9,1344939,1291027,53912,4.0,AR
136,2016,May,58.2,55.9,1344591,1290913,53678,4.0,AR
137,2016,Jun,58.2,55.9,1344422,1290844,53578,4.0,AR
138,2016,Jul,58.1,55.8,1344309,1290861,53448,4.0,AR
139,2016,Aug,58.1,55.8,1344072,1290838,53234,4.0,AR
140,2016,Sep,58.0,55.8,1343648,1290648,53000,3.9,AR
141,2016,Oct,58.0,55.7,1342910,1290250,52660,3.9,AR
142,2016,Nov,57.9,55.7,1342237,1290085,52152,3.9,AR
143,2016,Dec,57.9,55.7,1342177,1290651,51526,3.8,AR
144,2017,Jan,58.1,55.9,1340807,1290170,50637,3.8,AR
145,2017,Feb,58.2,56.0,1342683,1292667,50016,3.7,AR
146,2017,Mar,58.2,56.1,1345009,1295409,49600,3.7,AR
147,2017,Apr,58.3,56.2,1347419,1297981,49438,3.7,AR
148,2017,May,58.4,56.3,1349569,1300097,49472,3.7,AR
149,2017,Jun,58.4,56.3,1351134,1301422,49712,3.7,AR
150,2017,Jul,58.5,56.3,1351933,1301824,50109,3.7,AR
151,2017,Aug,58.4,56.2,1351813,1301295,50518,3.7,AR
152,2017,Sep,58.4,56.2,1350879,1300061,50818,3.8,AR
153,2017,Oct,58.3,56.1,1349529,1298573,50956,3.8,AR
154,2017,Nov,58.2,56.0,1348158,1297139,51019,3.8,AR
155,2017,Dec,58.1,55.9,1347206,1296258,50948,3.8,AR
156,2018,Jan,58.1,55.9,1346988,1296221,50767,3.8,AR
157,2018,Feb,58.1,56.0,1347645,1297171,50474,3.7,AR
158,2018,Mar,58.2,56.0,1348903,1298923,49980,3.7,AR
159,2018,Apr,58.2,56.1,1349993,1300735,49258,3.6,AR
160,2018,May,58.2,56.1,1350426,1301908,48518,3.6,AR
161,2018,Jun,58.2,56.1,1350393,1302450,47943,3.6,AR
162,2018,Jul,58.2,56.1,1350271,1302622,47649,3.5,AR
163,2018,Aug,58.2,56.1,1350725,1302919,47806,3.5,AR
164,2018,Sep,58.2,56.1,1352197,1303757,48440,3.6,AR
165,2018,Oct,58.3,56.2,1354601,1305344,49257,3.6,AR
166,2018,Nov,58.4,56.2,1357512,1307684,49828,3.7,AR
167,2018,Dec,58.5,56.3,1360370,1310519,49851,3.7,AR
168,2019,Jan,58.6,56.5,1362602,1313365,49237,3.6,AR
169,2019,Feb,58.6,56.5,1363906,1315774,48132,3.5,AR
170,2019,Mar,58.6,56.6,1364259,1317269,46990,3.4,AR
171,2019,Apr,58.6,56.6,1364020,1317875,46145,3.4,AR
172,2019,May,58.6,56.6,1363616,1317815,45801,3.4,AR
173,2019,Jun,58.5,56.6,1363502,1317463,46039,3.4,AR
174,2019,Jul,58.5,56.5,1364006,1317280,46726,3.4,AR
175,2019,Aug,58.5,56.5,1365145,1317678,47467,3.5,AR
176,2019,Sep,58.6,56.5,1366734,1318945,47789,3.5,AR
177,2019,Oct,58.6,56.6,1368464,1320642,47822,3.5,AR
178,2019,Nov,58.6,56.6,1369814,1322015,47799,3.5,AR
179,2019,Dec,58.6,56.6,1370084,1322185,47899,3.5,AR
180,2020,Jan,58.6,56.5,1369218,1321046,48172,3.5,AR
181,2020,Feb,58.5,56.4,1367618,1319012,48606,3.6,AR
182,2020,Mar,59.3,56.3,1385981,1317494,68487,4.9,AR
183,2020,Apr,59.0,53.1,1381107,1242557,138550,10.0,AR
184,2020,May,58.3,53.3,1365465,1246160,119305,8.7,AR
185,2020,Jun,57.8,53.4,1354029,1250914,103115,7.6,AR
186,2020,Jul,57.8,53.7,1353239,1257729,95510,7.1,AR
187,2020,Aug,57.4,53.9,1346158,1262734,83424,6.2,AR
188,2020,Sep,57.4,54.0,1345464,1266785,78679,5.8,AR
189,2020,Oct,57.1,54.0,1339560,1267889,71671,5.4,AR
190,2020,Nov,56.9,54.0,1337106,1268131,68975,5.2,AR
191,2020,Dec,56.8,54.0,1335440,1268083,67357,5.0,AR
192,2021,Jan,56.7,54.0,1333060,1268247,64813,4.9,AR
193,2021,Feb,56.7,54.0,1332313,1268940,63373,4.8,AR
194,2021,Mar,56.7,54.0,1332788,1270865,61923,4.6,AR
195,2021,Apr,56.7,54.1,1333117,1272833,60284,4.5,AR
196,2021,May,56.6,54.1,1332758,1274656,58102,4.4,AR
197,2021,Jun,56.6,54.2,1332580,1276205,56375,4.2,AR
198,2021,Jul,56.5,54.2,1331143,1277988,53155,4.0,AR
199,2021,Aug,56.4,54.3,1330686,1280596,50090,3.8,AR
200,2021,Sep,56.3,54.3,1330685,1283697,46988,3.5,AR
201,2021,Oct,56.3,54.4,1331746,1286851,44895,3.4,AR
202,2021,Nov,56.3,54.4,1331333,1287392,43941,3.3,AR
203,2021,Dec,56.2,54.4,1330743,1287166,43577,3.3,AR
204,2022,Jan,56.3,54.5,1334809,1292199,42610,3.2,AR
205,2022,Feb,56.5,54.7,1339399,1297210,42189,3.1,AR
206,2022,Mar,56.6,54.9,1343906,1302450,41456,3.1,AR
207,2022,Apr,56.8,55.0,1349553,1306960,42593,3.2,AR
208,2022,May,56.9,55.1,1352042,1309272,42770,3.2,AR
209,2022,Jun,57.0,55.1,1354855,1311381,43474,3.2,AR
210,2022,Jul,57.0,55.1,1356042,1311429,44613,3.3,AR
211,2022,Aug,56.8,54.9,1354290,1308654,45636,3.4,AR
212,2022,Sep,56.8,54.8,1353668,1306242,47426,3.5,AR
213,2022,Oct,56.7,54.6,1353161,1304631,48530,3.6,AR
214,2022,Nov,56.6,54.5,1351744,1302339,49405,3.7,AR
0,2005,Jan,71.1,68.5,275949,265961,9988,3.6,WY
1,2005,Feb,71.2,68.6,276375,266495,9880,3.6,WY
2,2005,Mar,71.3,68.7,276936,267105,9831,3.5,WY
3,2005,Apr,71.4,68.9,277618,267780,9838,3.5,WY
4,2005,May,71.6,69.0,278399,268517,9882,3.5,WY
5,2005,Jun,71.7,69.1,279173,269233,9940,3.6,WY
6,2005,Jul,71.8,69.2,279863,269845,10018,3.6,WY
7,2005,Aug,71.9,69.3,280397,270322,10075,3.6,WY
8,2005,Sep,71.8,69.3,280752,270691,10061,3.6,WY
9,2005,Oct,71.8,69.2,280982,271027,9955,3.5,WY
10,2005,Nov,71.7,69.2,281156,271399,9757,3.5,WY
11,2005,Dec,71.6,69.2,281322,271850,9472,3.4,WY
12,2006,Jan,71.6,69.3,281549,272423,9126,3.2,WY
13,2006,Feb,71.6,69.4,281877,273094,8783,3.1,WY
14,2006,Mar,71.6,69.5,282331,273809,8522,3.0,WY
15,2006,Apr,71.7,69.6,282905,274513,8392,3.0,WY
16,2006,May,71.8,69.7,283567,275179,8388,3.0,WY
17,2006,Jun,71.9,69.7,284276,275795,8481,3.0,WY
18,2006,Jul,72.0,69.8,285048,276434,8614,3.0,WY
19,2006,Aug,72.1,69.9,285874,277156,8718,3.0,WY
20,2006,Sep,72.1,69.9,286704,277957,8747,3.1,WY
21,2006,Oct,72.2,70.0,287463,278828,8635,3.0,WY
22,2006,Nov,72.2,70.1,288093,279707,8386,2.9,WY
23,2006,Dec,72.2,70.2,288545,280486,8059,2.8,WY
24,2007,Jan,72.2,70.3,288825,281087,7738,2.7,WY
25,2007,Feb,72.1,70.3,289039,281520,7519,2.6,WY
26,2007,Mar,72.1,70.2,289270,281824,7446,2.6,WY
27,2007,Apr,72.1,70.2,289584,282060,7524,2.6,WY
28,2007,May,72.0,70.1,290015,282297,7718,2.7,WY
29,2007,Jun,72.1,70.1,290549,282594,7955,2.7,WY
30,2007,Jul,72.1,70.1,291070,282958,8112,2.8,WY
31,2007,Aug,72.1,70.1,291531,283401,8130,2.8,WY
32,2007,Sep,72.1,70.1,291994,283956,8038,2.8,WY
33,2007,Oct,72.1,70.1,292498,284587,7911,2.7,WY
34,2007,Nov,72.1,70.2,293057,285260,7797,2.7,WY
35,2007,Dec,72.1,70.3,293644,285941,7703,2.6,WY
36,2008,Jan,72.2,70.3,294176,286531,7645,2.6,WY
37,2008,Feb,72.2,70.3,294628,286996,7632,2.6,WY
38,2008,Mar,72.2,70.3,295041,287354,7687,2.6,WY
39,2008,Apr,72.2,70.3,295452,287625,7827,2.6,WY
40,2008,May,72.2,70.2,295913,287868,8045,2.7,WY
41,2008,Jun,72.2,70.2,296475,288145,8330,2.8,WY
42,2008,Jul,72.3,70.2,297099,288449,8650,2.9,WY
43,2008,Aug,72.3,70.1,297673,288702,8971,3.0,WY
44,2008,Sep,72.3,70.0,298023,288770,9253,3.1,WY
45,2008,Oct,72.2,69.8,298085,288534,9551,3.2,WY
46,2008,Nov,72.0,69.6,298010,287926,10084,3.4,WY
47,2008,Dec,71.9,69.3,298049,287005,11044,3.7,WY
48,2009,Jan,71.9,68.9,298360,285891,12469,4.2,WY
49,2009,Feb,71.9,68.5,298950,284717,14233,4.8,WY
50,2009,Mar,72.0,68.1,299720,283647,16073,5.4,WY
51,2009,Apr,72.1,67.8,300461,282792,17669,5.9,WY
52,2009,May,72.1,67.6,300897,282070,18827,6.3,WY
53,2009,Jun,71.9,67.3,300868,281384,19484,6.5,WY
54,2009,Jul,71.7,67.0,300467,280658,19809,6.6,WY
55,2009,Aug,71.6,66.8,299950,279871,20079,6.7,WY
56,2009,Sep,71.4,66.5,299610,279101,20509,6.8,WY
57,2009,Oct,71.4,66.3,299628,278438,21190,7.1,WY
58,2009,Nov,71.4,66.2,300001,278031,21970,7.3,WY
59,2009,Dec,71.5,66.1,300619,277989,22630,7.5,WY
60,2010,Jan,71.6,66.2,301350,278343,23007,7.6,WY
61,2010,Feb,71.7,66.3,301933,278975,22958,7.6,WY
62,2010,Mar,71.8,66.4,302202,279686,22516,7.5,WY
63,2010,Apr,69.8,64.7,302183,280341,21842,7.2,WY
64,2010,May,69.7,64.8,301985,280897,21088,7.0,WY
65,2010,Jun,69.6,64.9,301753,281308,20445,6.8,WY
66,2010,Jul,69.5,64.9,301585,281564,20021,6.6,WY
67,2010,Aug,69.4,64.9,301540,281736,19804,6.6,WY
68,2010,Sep,69.4,64.9,301652,281862,19790,6.6,WY
69,2010,Oct,69.4,64.9,301921,282034,19887,6.6,WY
70,2010,Nov,69.5,64.9,302247,282256,19991,6.6,WY
71,2010,Dec,69.5,64.9,302487,282475,20012,6.6,WY
72,2011,Jan,69.5,64.9,302548,282676,19872,6.6,WY
73,2011,Feb,69.4,64.9,302436,282854,19582,6.5,WY
74,2011,Mar,69.3,64.9,302188,283016,19172,6.3,WY
75,2011,Apr,69.2,65.0,301888,283155,18733,6.2,WY
76,2011,May,69.2,65.0,301719,283312,18407,6.1,WY
77,2011,Jun,69.2,65.0,301800,283564,18236,6.0,WY
78,2011,Jul,69.2,65.0,302182,283980,18202,6.0,WY
79,2011,Aug,69.2,65.1,302814,284545,18269,6.0,WY
80,2011,Sep,69.3,65.1,303525,285193,18332,6.0,WY
81,2011,Oct,69.3,65.1,304140,285821,18319,6.0,WY
82,2011,Nov,69.3,65.2,304504,286325,18179,6.0,WY
83,2011,Dec,69.2,65.1,304580,286683,17897,5.9,WY
84,2012,Jan,69.1,65.1,304445,286913,17532,5.8,WY
85,2012,Feb,68.9,65.0,304220,287031,17189,5.7,WY
86,2012,Mar,68.8,65.0,303990,287027,16963,5.6,WY
87,2012,Apr,68.6,64.8,303802,286933,16869,5.6,WY
88,2012,May,68.5,64.7,303711,286848,16863,5.6,WY
89,2012,Jun,68.4,64.6,303733,286852,16881,5.6,WY
90,2012,Jul,68.3,64.6,303794,286966,16828,5.5,WY
91,2012,Aug,68.3,64.5,303836,287159,16677,5.5,WY
92,2012,Sep,68.2,64.5,303842,287381,16461,5.4,WY
93,2012,Oct,68.1,64.5,303715,287540,16175,5.3,WY
94,2012,Nov,68.0,64.4,303456,287578,15878,5.2,WY
95,2012,Dec,67.9,64.4,303094,287479,15615,5.2,WY
96,2013,Jan,67.7,64.3,302668,287303,15365,5.1,WY
97,2013,Feb,67.6,64.2,302300,287193,15107,5.0,WY
98,2013,Mar,67.5,64.2,302083,287262,14821,4.9,WY
99,2013,Apr,67.4,64.2,302063,287539,14524,4.8,WY
100,2013,May,67.4,64.2,302153,287874,14279,4.7,WY
101,2013,Jun,67.4,64.2,302234,288123,14111,4.7,WY
102,2013,Jul,67.3,64.2,302271,288226,14045,4.6,WY
103,2013,Aug,67.3,64.2,302231,288200,14031,4.6,WY
104,2013,Sep,67.2,64.1,302130,288119,14011,4.6,WY
105,2013,Oct,67.2,64.1,302077,288075,14002,4.6,WY
106,2013,Nov,67.2,64.1,302109,288157,13952,4.6,WY
107,2013,Dec,67.2,64.2,302194,288374,13820,4.6,WY
108,2014,Jan,67.3,64.2,302308,288675,13633,4.5,WY
109,2014,Feb,67.3,64.3,302412,288990,13422,4.4,WY
110,2014,Mar,67.3,64.4,302506,289248,13258,4.4,WY
111,2014,Apr,67.3,64.4,302590,289389,13201,4.4,WY
112,2014,May,67.4,64.4,302688,289475,13213,4.4,WY
113,2014,Jun,67.4,64.4,302902,289593,13309,4.4,WY
114,2014,Jul,67.5,64.5,303175,289739,13436,4.4,WY
115,2014,Aug,67.5,64.5,303393,289922,13471,4.4,WY
116,2014,Sep,67.4,64.5,303460,290127,13333,4.4,WY
117,2014,Oct,67.4,64.5,303319,290316,13003,4.3,WY
118,2014,Nov,67.3,64.5,302997,290435,12562,4.1,WY
119,2014,Dec,67.2,64.5,302631,290474,12157,4.0,WY
120,2015,Jan,67.1,64.5,302350,290427,11923,3.9,WY
121,2015,Feb,67.0,64.4,302209,290287,11922,3.9,WY
122,2015,Mar,67.0,64.3,302218,290102,12116,4.0,WY
123,2015,Apr,67.0,64.3,302299,289899,12400,4.1,WY
124,2015,May,67.0,64.2,302311,289650,12661,4.2,WY
125,2015,Jun,66.9,64.1,302119,289316,12803,4.2,WY
126,2015,Jul,66.8,64.0,301719,288919,12800,4.2,WY
127,2015,Aug,66.7,63.9,301250,288478,12772,4.2,WY
128,2015,Sep,66.6,63.8,300853,288034,12819,4.3,WY
129,2015,Oct,66.6,63.7,300679,287649,13030,4.3,WY
130,2015,Nov,66.6,63.6,300834,287332,13502,4.5,WY
131,2015,Dec,66.7,63.6,301280,287030,14250,4.7,WY
132,2016,Jan,66.9,63.5,301853,286696,15157,5.0,WY
133,2016,Feb,67.0,63.4,302351,286294,16057,5.3,WY
134,2016,Mar,67.0,63.3,302567,285818,16749,5.5,WY
135,2016,Apr,67.0,63.2,302403,285301,17102,5.7,WY
136,2016,May,66.9,63.1,301896,284797,17099,5.7,WY
137,2016,Jun,66.7,63.0,301109,284349,16760,5.6,WY
138,2016,Jul,66.5,62.9,300247,283973,16274,5.4,WY
139,2016,Aug,66.4,62.9,299501,283660,15841,5.3,WY
140,2016,Sep,66.3,62.9,298941,283384,15557,5.2,WY
141,2016,Oct,66.3,62.8,298556,283145,15411,5.2,WY
142,2016,Nov,66.2,62.8,298248,282998,15250,5.1,WY
143,2016,Dec,66.2,62.9,297901,282982,14919,5.0,WY
144,2017,Jan,66.1,62.9,295389,281107,14282,4.8,WY
145,2017,Feb,66.0,63.0,294904,281308,13596,4.6,WY
146,2017,Mar,66.0,63.1,294438,281517,12921,4.4,WY
147,2017,Apr,65.9,63.2,294093,281693,12400,4.2,WY
148,2017,May,65.9,63.2,293917,281799,12118,4.1,WY
149,2017,Jun,66.0,63.2,293892,281770,12122,4.1,WY
150,2017,Jul,66.0,63.2,293905,281599,12306,4.2,WY
151,2017,Aug,66.0,63.2,293795,281298,12497,4.3,WY
152,2017,Sep,65.9,63.1,293545,280899,12646,4.3,WY
153,2017,Oct,65.8,63.0,293166,280475,12691,4.3,WY
154,2017,Nov,65.7,62.9,292717,280093,12624,4.3,WY
155,2017,Dec,65.6,62.8,292334,279877,12457,4.3,WY
156,2018,Jan,65.6,62.8,292130,279900,12230,4.2,WY
157,2018,Feb,65.6,62.9,292193,280195,11998,4.1,WY
158,2018,Mar,65.7,63.0,292461,280654,11807,4.0,WY
159,2018,Apr,65.7,63.1,292740,281053,11687,4.0,WY
160,2018,May,65.8,63.2,292911,281245,11666,4.0,WY
161,2018,Jun,65.8,63.1,292974,281239,11735,4.0,WY
162,2018,Jul,65.8,63.1,292953,281087,11866,4.1,WY
163,2018,Aug,65.7,63.0,292930,280903,12027,4.1,WY
164,2018,Sep,65.7,63.0,292925,280805,12120,4.1,WY
165,2018,Oct,65.7,63.0,292929,280874,12055,4.1,WY
166,2018,Nov,65.6,63.0,292924,281120,11804,4.0,WY
167,2018,Dec,65.6,63.1,292875,281495,11380,3.9,WY
168,2019,Jan,65.6,63.1,292764,281926,10838,3.7,WY
169,2019,Feb,65.5,63.2,292650,282358,10292,3.5,WY
170,2019,Mar,65.5,63.3,292672,282755,9917,3.4,WY
171,2019,Apr,65.6,63.4,292944,283140,9804,3.3,WY
172,2019,May,65.7,63.4,293440,283475,9965,3.4,WY
173,2019,Jun,65.8,63.4,294059,283716,10343,3.5,WY
174,2019,Jul,65.9,63.4,294676,283835,10841,3.7,WY
175,2019,Aug,65.9,63.4,295201,283863,11338,3.8,WY
176,2019,Sep,66.0,63.4,295631,283915,11716,4.0,WY
177,2019,Oct,66.0,63.3,296047,283976,12071,4.1,WY
178,2019,Nov,66.1,63.3,296506,283984,12522,4.2,WY
179,2019,Dec,66.2,63.2,296896,283770,13126,4.4,WY
180,2020,Jan,66.2,63.1,297103,283219,13884,4.7,WY
181,2020,Feb,66.1,62.9,297035,282348,14687,4.9,WY
182,2020,Mar,66.0,62.6,296702,281396,15306,5.2,WY
183,2020,Apr,64.1,60.7,288335,272723,15612,5.4,WY
184,2020,May,66.3,60.6,298314,272632,25682,8.6,WY
185,2020,Jun,65.4,60.7,294108,273032,21076,7.2,WY
186,2020,Jul,65.2,60.9,293336,274047,19289,6.6,WY
187,2020,Aug,64.9,61.1,292404,275105,17299,5.9,WY
188,2020,Sep,64.9,61.2,292330,276005,16325,5.6,WY
189,2020,Oct,64.7,61.3,291789,276377,15412,5.3,WY
190,2020,Nov,64.6,61.2,291440,276394,15046,5.2,WY
191,2020,Dec,64.5,61.2,291200,276231,14969,5.1,WY
192,2021,Jan,64.4,61.1,290921,276131,14790,5.1,WY
193,2021,Feb,64.4,61.1,290883,276229,14654,5.0,WY
194,2021,Mar,64.3,61.2,290946,276539,14407,5.0,WY
195,2021,Apr,64.3,61.2,290962,276880,14082,4.8,WY
196,2021,May,64.2,61.2,290753,277103,13650,4.7,WY
197,2021,Jun,64.1,61.2,290486,277176,13310,4.6,WY
198,2021,Jul,64.0,61.1,290132,277210,12922,4.5,WY
199,2021,Aug,63.9,61.1,289856,277344,12512,4.3,WY
200,2021,Sep,63.8,61.1,289705,277650,12055,4.2,WY
201,2021,Oct,63.7,61.2,289766,278088,11678,4.0,WY
202,2021,Nov,63.7,61.2,289808,278252,11556,4.0,WY
203,2021,Dec,63.6,61.1,289831,278283,11548,4.0,WY
204,2022,Jan,63.7,61.3,290102,279063,11039,3.8,WY
205,2022,Feb,63.7,61.3,290282,279691,10591,3.6,WY
206,2022,Mar,63.6,61.5,290379,280512,9867,3.4,WY
207,2022,Apr,63.7,61.6,290691,281100,9591,3.3,WY
208,2022,May,63.7,61.6,290847,281630,9217,3.2,WY
209,2022,Jun,63.5,61.6,290622,281672,8950,3.1,WY
210,2022,Jul,63.4,61.5,290095,281315,8780,3.0,WY
211,2022,Aug,63.2,61.2,289642,280571,9071,3.1,WY
212,2022,Sep,63.1,61.0,289358,279874,9484,3.3,WY
213,2022,Oct,63.0,60.8,289283,279240,10043,3.5,WY
214,2022,Nov,63.0,60.7,289414,279067,10347,3.6,WY
0,2005,Jan,71.5,68.2,1254218,1197310,56908,4.5,UT
1,2005,Feb,71.6,68.4,1259004,1202700,56304,4.5,UT
2,2005,Mar,71.7,68.6,1264021,1208513,55508,4.4,UT
3,2005,Apr,71.9,68.8,1269262,1214708,54554,4.3,UT
4,2005,May,72.0,69.0,1274652,1221155,53497,4.2,UT
5,2005,Jun,72.1,69.2,1279876,1227458,52418,4.1,UT
6,2005,Jul,72.3,69.4,1284707,1233299,51408,4.0,UT
7,2005,Aug,72.3,69.5,1288990,1238581,50409,3.9,UT
8,2005,Sep,72.3,69.5,1292779,1243398,49381,3.8,UT
9,2005,Oct,72.2,69.6,1296320,1248068,48252,3.7,UT
10,2005,Nov,72.2,69.6,1299869,1252829,47040,3.6,UT
11,2005,Dec,72.2,69.7,1303593,1257816,45777,3.5,UT
12,2006,Jan,72.3,69.8,1307644,1263185,44459,3.4,UT
13,2006,Feb,72.3,69.9,1311981,1268854,43127,3.3,UT
14,2006,Mar,72.4,70.1,1316509,1274637,41872,3.2,UT
15,2006,Apr,72.4,70.2,1321063,1280361,40702,3.1,UT
16,2006,May,72.5,70.3,1325529,1286032,39497,3.0,UT
17,2006,Jun,72.5,70.5,1329902,1291669,38233,2.9,UT
18,2006,Jul,72.6,70.6,1334478,1297521,36957,2.8,UT
19,2006,Aug,72.7,70.7,1339519,1303704,35815,2.7,UT
20,2006,Sep,72.8,70.9,1344922,1310071,34851,2.6,UT
21,2006,Oct,72.9,71.1,1350404,1316400,34004,2.5,UT
22,2006,Nov,73.0,71.2,1355691,1322348,33343,2.5,UT
23,2006,Dec,73.1,71.3,1360400,1327488,32912,2.4,UT
24,2007,Jan,73.1,71.4,1364352,1331564,32788,2.4,UT
25,2007,Feb,73.1,71.4,1367666,1334719,32947,2.4,UT
26,2007,Mar,73.1,71.3,1370319,1337078,33241,2.4,UT
27,2007,Apr,73.0,71.3,1372517,1338904,33613,2.4,UT
28,2007,May,73.0,71.2,1374601,1340503,34098,2.5,UT
29,2007,Jun,72.9,71.1,1376750,1342100,34650,2.5,UT
30,2007,Jul,72.9,71.0,1378927,1343693,35234,2.6,UT
31,2007,Aug,72.8,70.9,1381216,1345301,35915,2.6,UT
32,2007,Sep,72.8,70.9,1383625,1346964,36661,2.6,UT
33,2007,Oct,72.8,70.8,1385953,1348475,37478,2.7,UT
34,2007,Nov,72.8,70.8,1387937,1349690,38247,2.8,UT
35,2007,Dec,72.7,70.7,1389416,1350526,38890,2.8,UT
36,2008,Jan,72.6,70.5,1390196,1350736,39460,2.8,UT
37,2008,Feb,72.5,70.4,1390331,1350305,40026,2.9,UT
38,2008,Mar,72.3,70.2,1390054,1349332,40722,2.9,UT
39,2008,Apr,72.2,70.0,1389475,1347866,41609,3.0,UT
40,2008,May,72.0,69.8,1388638,1345995,42643,3.1,UT
41,2008,Jun,71.8,69.5,1387616,1343861,43755,3.2,UT
42,2008,Jul,71.6,69.3,1386267,1341399,44868,3.2,UT
43,2008,Aug,71.4,69.0,1384255,1338357,45898,3.3,UT
44,2008,Sep,71.1,68.7,1381301,1334384,46917,3.4,UT
45,2008,Oct,70.8,68.3,1377244,1329258,47986,3.5,UT
46,2008,Nov,70.4,67.9,1371962,1322915,49047,3.6,UT
47,2008,Dec,71.1,67.4,1388245,1315656,72589,5.2,UT
48,2009,Jan,71.2,66.9,1392634,1307934,84700,6.1,UT
49,2009,Feb,71.0,66.4,1391346,1300274,91072,6.5,UT
50,2009,Mar,70.8,65.9,1387931,1293342,94589,6.8,UT
51,2009,Apr,70.5,65.5,1384192,1287412,96780,7.0,UT
52,2009,May,70.2,65.2,1380535,1282005,98530,7.1,UT
53,2009,Jun,69.9,64.8,1376948,1276697,100251,7.3,UT
54,2009,Jul,69.6,64.4,1373141,1271180,101961,7.4,UT
55,2009,Aug,69.2,64.0,1368895,1265371,103524,7.6,UT
56,2009,Sep,68.9,63.6,1364462,1259612,104850,7.7,UT
57,2009,Oct,68.6,63.2,1360205,1254310,105895,7.8,UT
58,2009,Nov,68.3,62.9,1356818,1250061,106757,7.9,UT
59,2009,Dec,68.1,62.7,1354784,1247251,107533,7.9,UT
60,2010,Jan,68.0,62.6,1354098,1245935,108163,8.0,UT
61,2010,Feb,67.9,62.5,1354151,1245598,108553,8.0,UT
62,2010,Mar,67.8,62.4,1354198,1245524,108674,8.0,UT
63,2010,Apr,69.4,63.8,1353881,1245364,108517,8.0,UT
64,2010,May,69.2,63.7,1353095,1245042,108053,8.0,UT
65,2010,Jun,69.1,63.6,1351732,1244308,107424,7.9,UT
66,2010,Jul,68.9,63.4,1350000,1243121,106879,7.9,UT
67,2010,Aug,68.7,63.3,1348321,1241798,106523,7.9,UT
68,2010,Sep,68.5,63.1,1346821,1240547,106274,7.9,UT
69,2010,Oct,68.4,63.0,1345724,1239726,105998,7.9,UT
70,2010,Nov,68.2,62.9,1345016,1239409,105607,7.9,UT
71,2010,Dec,68.1,62.8,1344606,1239497,105109,7.8,UT
72,2011,Jan,68.0,62.7,1344519,1239913,104606,7.8,UT
73,2011,Feb,67.9,62.7,1344597,1240415,104182,7.7,UT
74,2011,Mar,67.9,62.6,1344706,1240829,103877,7.7,UT
75,2011,Apr,67.8,62.5,1344845,1241064,103781,7.7,UT
76,2011,May,67.7,62.5,1345294,1241349,103945,7.7,UT
77,2011,Jun,67.7,62.4,1346394,1242153,104241,7.7,UT
78,2011,Jul,67.4,62.4,1342776,1243911,98865,7.4,UT
79,2011,Aug,67.2,62.5,1340068,1246666,93402,7.0,UT
80,2011,Sep,67.0,62.6,1338091,1250211,87880,6.6,UT
81,2011,Oct,66.8,62.7,1336631,1254196,82435,6.2,UT
82,2011,Nov,66.6,62.8,1335333,1258132,77201,5.8,UT
83,2011,Dec,66.5,62.9,1333971,1261754,72217,5.4,UT
84,2012,Jan,66.4,62.9,1335279,1265082,70197,5.3,UT
85,2012,Feb,66.2,63.0,1331198,1268263,62935,4.7,UT
86,2012,Mar,66.3,63.1,1335297,1271263,64034,4.8,UT
87,2012,Apr,66.4,63.1,1338994,1274152,64842,4.8,UT
88,2012,May,66.4,63.2,1342475,1277306,65169,4.9,UT
89,2012,Jun,66.5,63.3,1345980,1280955,65025,4.8,UT
90,2012,Jul,66.6,63.4,1349636,1285107,64529,4.8,UT
91,2012,Aug,66.7,63.5,1353555,1289584,63971,4.7,UT
92,2012,Sep,66.8,63.6,1357700,1294133,63567,4.7,UT
93,2012,Oct,66.8,63.7,1361555,1298314,63241,4.6,UT
94,2012,Nov,66.9,63.8,1364818,1301946,62872,4.6,UT
95,2012,Dec,66.9,63.9,1367434,1305067,62367,4.6,UT
96,2013,Jan,66.9,63.9,1369579,1307839,61740,4.5,UT
97,2013,Feb,67.0,64.0,1371797,1310766,61031,4.4,UT
98,2013,Mar,67.0,64.1,1374623,1314333,60290,4.4,UT
99,2013,Apr,67.1,64.2,1378344,1318709,59635,4.3,UT
100,2013,May,67.2,64.3,1382531,1323353,59178,4.3,UT
101,2013,Jun,67.3,64.4,1386526,1327663,58863,4.2,UT
102,2013,Jul,67.3,64.5,1389933,1331380,58553,4.2,UT
103,2013,Aug,67.3,64.5,1392500,1334511,57989,4.2,UT
104,2013,Sep,67.3,64.6,1394372,1337267,57105,4.1,UT
105,2013,Oct,67.3,64.6,1396158,1339974,56184,4.0,UT
106,2013,Nov,67.3,64.7,1398215,1342906,55309,4.0,UT
107,2013,Dec,67.3,64.7,1400436,1346017,54419,3.9,UT
108,2014,Jan,67.4,64.8,1402644,1349185,53459,3.8,UT
109,2014,Feb,67.4,64.8,1404680,1352211,52469,3.7,UT
110,2014,Mar,67.4,64.9,1406514,1354871,51643,3.7,UT
111,2014,Apr,67.3,64.9,1408112,1357035,51077,3.6,UT
112,2014,May,67.3,64.9,1409831,1359074,50757,3.6,UT
113,2014,Jun,67.3,64.9,1412233,1361525,50708,3.6,UT
114,2014,Jul,67.4,65.0,1415313,1364434,50879,3.6,UT
115,2014,Aug,67.5,65.0,1418964,1367794,51170,3.6,UT
116,2014,Sep,67.5,65.1,1422899,1371451,51448,3.6,UT
117,2014,Oct,67.6,65.1,1426616,1375102,51514,3.6,UT
118,2014,Nov,67.6,65.2,1429762,1378419,51343,3.6,UT
119,2014,Dec,67.7,65.2,1432638,1381478,51160,3.6,UT
120,2015,Jan,67.7,65.3,1435490,1384452,51038,3.6,UT
121,2015,Feb,67.7,65.3,1438477,1387444,51033,3.5,UT
122,2015,Mar,67.8,65.4,1441814,1390696,51118,3.5,UT
123,2015,Apr,67.8,65.4,1445478,1394232,51246,3.5,UT
124,2015,May,67.9,65.5,1449095,1397733,51362,3.5,UT
125,2015,Jun,67.9,65.5,1452297,1400856,51441,3.5,UT
126,2015,Jul,68.0,65.6,1455143,1403612,51531,3.5,UT
127,2015,Aug,67.9,65.5,1457886,1406235,51651,3.5,UT
128,2015,Sep,67.9,65.5,1460802,1409096,51706,3.5,UT
129,2015,Oct,67.9,65.5,1464379,1412676,51703,3.5,UT
130,2015,Nov,68.0,65.6,1468832,1417067,51765,3.5,UT
131,2015,Dec,68.1,65.7,1473799,1421939,51860,3.5,UT
132,2016,Jan,68.2,65.8,1478801,1426877,51924,3.5,UT
133,2016,Feb,68.3,65.9,1483530,1431601,51929,3.5,UT
134,2016,Mar,68.3,66.0,1487708,1435988,51720,3.5,UT
135,2016,Apr,68.4,66.0,1491391,1440100,51291,3.4,UT
136,2016,May,68.4,66.0,1494904,1444126,50778,3.4,UT
137,2016,Jun,68.4,66.1,1498447,1448202,50245,3.4,UT
138,2016,Jul,68.4,66.1,1502055,1452325,49730,3.3,UT
139,2016,Aug,68.4,66.2,1505706,1456380,49326,3.3,UT
140,2016,Sep,68.4,66.2,1509362,1460215,49147,3.3,UT
141,2016,Oct,68.5,66.2,1512986,1463848,49138,3.2,UT
142,2016,Nov,68.5,66.3,1516777,1467644,49133,3.2,UT
143,2016,Dec,68.5,66.3,1520948,1471879,49069,3.2,UT
144,2017,Jan,68.6,66.4,1533260,1484178,49082,3.2,UT
145,2017,Feb,68.7,66.5,1538289,1489301,48988,3.2,UT
146,2017,Mar,68.8,66.6,1543308,1494287,49021,3.2,UT
147,2017,Apr,68.9,66.7,1548135,1498943,49192,3.2,UT
148,2017,May,68.9,66.7,1552513,1503169,49344,3.2,UT
149,2017,Jun,68.9,66.7,1556173,1506746,49427,3.2,UT
150,2017,Jul,68.9,66.7,1559136,1509675,49461,3.2,UT
151,2017,Aug,68.9,66.7,1561331,1511971,49360,3.2,UT
152,2017,Sep,68.8,66.6,1562843,1513729,49114,3.1,UT
153,2017,Oct,68.7,66.6,1563968,1515235,48733,3.1,UT
154,2017,Nov,68.6,66.5,1564982,1516673,48309,3.1,UT
155,2017,Dec,68.6,66.5,1566384,1518553,47831,3.1,UT
156,2018,Jan,68.5,66.5,1568655,1521272,47383,3.0,UT
157,2018,Feb,68.6,66.5,1572031,1525005,47026,3.0,UT
158,2018,Mar,68.6,66.6,1576092,1529314,46778,3.0,UT
159,2018,Apr,68.6,66.6,1579895,1533277,46618,3.0,UT
160,2018,May,68.6,66.6,1582778,1536229,46549,2.9,UT
161,2018,Jun,68.6,66.6,1584690,1538169,46521,2.9,UT
162,2018,Jul,68.5,66.5,1585815,1539373,46442,2.9,UT
163,2018,Aug,68.4,66.4,1586788,1540430,46358,2.9,UT
164,2018,Sep,68.3,66.3,1588130,1541871,46259,2.9,UT
165,2018,Oct,68.3,66.3,1590094,1544054,46040,2.9,UT
166,2018,Nov,68.3,66.3,1592736,1547118,45618,2.9,UT
167,2018,Dec,68.3,66.4,1595916,1550916,45000,2.8,UT
168,2019,Jan,68.3,66.4,1599349,1555101,44248,2.8,UT
169,2019,Feb,68.3,66.5,1602860,1559443,43417,2.7,UT
170,2019,Mar,68.4,66.6,1606392,1563707,42685,2.7,UT
171,2019,Apr,68.4,66.6,1610053,1567954,42099,2.6,UT
172,2019,May,68.4,66.7,1613711,1572035,41676,2.6,UT
173,2019,Jun,68.4,66.7,1617211,1575839,41372,2.6,UT
174,2019,Jul,68.5,66.7,1620427,1579297,41130,2.5,UT
175,2019,Aug,68.4,66.7,1623387,1582493,40894,2.5,UT
176,2019,Sep,68.4,66.7,1626495,1585929,40566,2.5,UT
177,2019,Oct,68.4,66.7,1629877,1589427,40450,2.5,UT
178,2019,Nov,68.5,66.8,1633162,1592495,40667,2.5,UT
179,2019,Dec,68.4,66.7,1635281,1594147,41134,2.5,UT
180,2020,Jan,68.3,66.6,1635538,1593924,41614,2.5,UT
181,2020,Feb,68.1,66.4,1633857,1592006,41851,2.6,UT
182,2020,Mar,67.9,66.2,1631235,1589690,41545,2.5,UT
183,2020,Apr,67.4,60.6,1621670,1458740,162930,10.0,UT
184,2020,May,67.7,62.6,1630827,1507645,123182,7.6,UT
185,2020,Jun,67.4,63.3,1628195,1527608,100587,6.2,UT
186,2020,Jul,67.7,64.0,1636376,1547412,88964,5.4,UT
187,2020,Aug,67.7,64.6,1640377,1564469,75908,4.6,UT
188,2020,Sep,67.9,65.0,1650040,1578807,71233,4.3,UT
189,2020,Oct,67.9,65.3,1653401,1589107,64294,3.9,UT
190,2020,Nov,67.9,65.5,1657266,1596542,60724,3.7,UT
191,2020,Dec,68.0,65.6,1660730,1602327,58403,3.5,UT
192,2021,Jan,67.9,65.7,1662490,1607823,54667,3.3,UT
193,2021,Feb,67.9,65.8,1665906,1613637,52269,3.1,UT
194,2021,Mar,68.0,65.9,1670033,1619819,50214,3.0,UT
195,2021,Apr,68.0,66.0,1674639,1625698,48941,2.9,UT
196,2021,May,68.0,66.1,1678424,1630846,47578,2.8,UT
197,2021,Jun,68.0,66.1,1681787,1634954,46833,2.8,UT
198,2021,Jul,68.0,66.1,1684468,1639099,45369,2.7,UT
199,2021,Aug,67.9,66.2,1686877,1643291,43586,2.6,UT
200,2021,Sep,67.8,66.2,1689246,1647835,41411,2.5,UT
201,2021,Oct,67.8,66.2,1691653,1651906,39747,2.3,UT
202,2021,Nov,67.7,66.1,1692232,1653196,39036,2.3,UT
203,2021,Dec,67.5,66.0,1692122,1653334,38788,2.3,UT
204,2022,Jan,67.5,66.0,1693957,1656600,37357,2.2,UT
205,2022,Feb,67.4,66.0,1697136,1661892,35244,2.1,UT
206,2022,Mar,67.6,66.3,1705518,1672168,33350,2.0,UT
207,2022,Apr,67.8,66.5,1714407,1681176,33231,1.9,UT
208,2022,May,68.0,66.7,1722826,1688795,34031,2.0,UT
209,2022,Jun,68.1,66.7,1728748,1693846,34902,2.0,UT
210,2022,Jul,68.1,66.7,1732461,1697305,35156,2.0,UT
211,2022,Aug,68.1,66.7,1735513,1700008,35505,2.0,UT
212,2022,Sep,68.0,66.6,1738346,1702184,36162,2.1,UT
213,2022,Oct,67.9,66.5,1740697,1703408,37289,2.1,UT
214,2022,Nov,67.9,66.5,1744723,1706536,38187,2.2,UT
0,2005,Jan,62.8,59.6,9395352,8913873,481479,5.1,NY
1,2005,Feb,62.8,59.6,9397267,8922290,474977,5.1,NY
2,2005,Mar,62.8,59.6,9402641,8933249,469392,5.0,NY
3,2005,Apr,62.8,59.7,9413319,8948092,465227,4.9,NY
4,2005,May,62.9,59.8,9430767,8967742,463025,4.9,NY
5,2005,Jun,63.0,59.9,9451917,8988295,463622,4.9,NY
6,2005,Jul,63.1,60.0,9471800,9004782,467018,4.9,NY
7,2005,Aug,63.2,60.1,9487602,9017089,470513,5.0,NY
8,2005,Sep,63.2,60.1,9499119,9027253,471866,5.0,NY
9,2005,Oct,63.2,60.1,9507494,9037183,470311,4.9,NY
10,2005,Nov,63.2,60.1,9513815,9046842,466973,4.9,NY
11,2005,Dec,63.2,60.1,9518216,9056031,462185,4.9,NY
12,2006,Jan,63.2,60.2,9522997,9066533,456464,4.8,NY
13,2006,Feb,63.2,60.2,9529175,9077960,451215,4.7,NY
14,2006,Mar,63.2,60.3,9535839,9087985,447854,4.7,NY
15,2006,Apr,63.3,60.3,9539977,9093660,446317,4.7,NY
16,2006,May,63.2,60.3,9538316,9093999,444317,4.7,NY
17,2006,Jun,63.2,60.2,9530898,9090653,440245,4.6,NY
18,2006,Jul,63.1,60.2,9520777,9087715,433062,4.5,NY
19,2006,Aug,63.0,60.2,9511488,9086770,424718,4.5,NY
20,2006,Sep,62.9,60.1,9505259,9087981,417278,4.4,NY
21,2006,Oct,62.8,60.1,9502793,9092269,410524,4.3,NY
22,2006,Nov,62.8,60.1,9503075,9098570,404505,4.3,NY
23,2006,Dec,62.8,60.1,9502870,9102977,399893,4.2,NY
24,2007,Jan,62.7,60.1,9499799,9102241,397558,4.2,NY
25,2007,Feb,62.6,60.0,9494831,9096946,397885,4.2,NY
26,2007,Mar,62.6,59.9,9488991,9088533,400458,4.2,NY
27,2007,Apr,62.5,59.8,9484728,9079753,404975,4.3,NY
28,2007,May,62.5,59.8,9484366,9073042,411324,4.3,NY
29,2007,Jun,62.5,59.7,9488494,9070029,418465,4.4,NY
30,2007,Jul,62.5,59.7,9497120,9071651,425469,4.5,NY
31,2007,Aug,62.5,59.7,9509680,9077545,432135,4.5,NY
32,2007,Sep,62.6,59.7,9525259,9087657,437602,4.6,NY
33,2007,Oct,62.7,59.8,9541506,9099049,442457,4.6,NY
34,2007,Nov,62.8,59.8,9556141,9109703,446438,4.7,NY
35,2007,Dec,62.8,59.9,9568190,9118591,449599,4.7,NY
36,2008,Jan,62.8,59.9,9577044,9124073,452971,4.7,NY
37,2008,Feb,62.9,59.9,9583530,9126805,456725,4.8,NY
38,2008,Mar,62.9,59.9,9590062,9128290,461772,4.8,NY
39,2008,Apr,62.9,59.8,9599018,9129190,469828,4.9,NY
40,2008,May,63.0,59.8,9612247,9130656,481591,5.0,NY
41,2008,Jun,63.1,59.8,9630028,9133515,496513,5.2,NY
42,2008,Jul,63.2,59.8,9649719,9136086,513633,5.3,NY
43,2008,Aug,63.3,59.8,9668018,9135938,532080,5.5,NY
44,2008,Sep,63.3,59.7,9682451,9129223,553228,5.7,NY
45,2008,Oct,63.4,59.6,9693575,9114128,579447,6.0,NY
46,2008,Nov,63.4,59.4,9703038,9091347,611691,6.3,NY
47,2008,Dec,63.4,59.2,9711658,9062948,648710,6.7,NY
48,2009,Jan,63.4,59.0,9719617,9031621,687996,7.1,NY
49,2009,Feb,63.5,58.7,9727756,9000993,726763,7.5,NY
50,2009,Mar,63.0,58.0,9657401,8896423,760978,7.9,NY
51,2009,Apr,63.0,57.9,9666899,8879394,787505,8.1,NY
52,2009,May,63.0,57.8,9672903,8866030,806873,8.3,NY
53,2009,Jun,63.0,57.7,9673753,8852531,821222,8.5,NY
54,2009,Jul,63.0,57.5,9668943,8836214,832729,8.6,NY
55,2009,Aug,62.9,57.4,9659298,8816461,842837,8.7,NY
56,2009,Sep,62.8,57.2,9647854,8796265,851589,8.8,NY
57,2009,Oct,62.7,57.1,9636718,8778512,858206,8.9,NY
58,2009,Nov,62.6,57.0,9630492,8767080,863412,9.0,NY
59,2009,Dec,62.6,56.9,9633209,8765800,867409,9.0,NY
60,2010,Jan,62.6,57.0,9644070,8775340,868730,9.0,NY
61,2010,Feb,62.7,57.1,9657047,8790529,866518,9.0,NY
62,2010,Mar,62.7,57.1,9666303,8804772,861531,8.9,NY
63,2010,Apr,63.0,57.5,9669447,8814800,854647,8.8,NY
64,2010,May,63.0,57.5,9665480,8819490,845990,8.8,NY
65,2010,Jun,62.9,57.4,9654362,8817095,837267,8.7,NY
66,2010,Jul,62.7,57.3,9638270,8807520,830750,8.6,NY
67,2010,Aug,62.6,57.2,9621243,8794278,826965,8.6,NY
68,2010,Sep,62.4,57.1,9605787,8780710,825077,8.6,NY
69,2010,Oct,62.3,57.0,9593183,8770596,822587,8.6,NY
70,2010,Nov,62.2,56.9,9581746,8764573,817173,8.5,NY
71,2010,Dec,62.1,56.8,9570220,8761434,808786,8.5,NY
72,2011,Jan,62.0,56.8,9559651,8760232,799419,8.4,NY
73,2011,Feb,61.9,56.7,9548708,8757912,790796,8.3,NY
74,2011,Mar,61.8,56.7,9536257,8752207,784050,8.2,NY
75,2011,Apr,61.6,56.6,9523346,8742652,780694,8.2,NY
76,2011,May,61.5,56.5,9513763,8731832,781931,8.2,NY
77,2011,Jun,61.5,56.4,9510326,8723753,786573,8.3,NY
78,2011,Jul,61.5,56.3,9514587,8722045,792542,8.3,NY
79,2011,Aug,61.5,56.3,9524566,8725968,798598,8.4,NY
80,2011,Sep,61.5,56.3,9536393,8732476,803917,8.4,NY
81,2011,Oct,61.6,56.4,9548032,8739046,808986,8.5,NY
82,2011,Nov,61.6,56.4,9556997,8743315,813682,8.5,NY
83,2011,Dec,61.6,56.3,9561987,8744223,817764,8.6,NY
84,2012,Jan,61.6,56.3,9564435,8742699,821736,8.6,NY
85,2012,Feb,61.6,56.3,9568747,8742066,826681,8.6,NY
86,2012,Mar,61.6,56.3,9575456,8742131,833325,8.7,NY
87,2012,Apr,61.6,56.2,9581857,8742019,839838,8.8,NY
88,2012,May,61.7,56.2,9588258,8744437,843821,8.8,NY
89,2012,Jun,61.7,56.2,9595186,8751630,843556,8.8,NY
90,2012,Jul,61.7,56.3,9602750,8764316,838434,8.7,NY
91,2012,Aug,61.7,56.4,9612652,8781926,830726,8.6,NY
92,2012,Sep,61.8,56.5,9625882,8802411,823471,8.6,NY
93,2012,Oct,61.8,56.6,9638067,8820734,817333,8.5,NY
94,2012,Nov,61.8,56.6,9645668,8833612,812056,8.4,NY
95,2012,Dec,61.8,56.7,9647282,8840572,806710,8.4,NY
96,2013,Jan,61.8,56.6,9643243,8842773,800470,8.3,NY
97,2013,Feb,61.7,56.6,9637148,8844420,792728,8.2,NY
98,2013,Mar,61.7,56.7,9634141,8850795,783346,8.1,NY
99,2013,Apr,61.7,56.7,9638121,8864330,773791,8.0,NY
100,2013,May,61.7,56.8,9646461,8880236,766225,7.9,NY
101,2013,Jun,61.8,56.9,9655330,8893914,761416,7.9,NY
102,2013,Jul,61.8,56.9,9660293,8902869,757424,7.8,NY
103,2013,Aug,61.7,56.9,9655577,8906160,749417,7.8,NY
104,2013,Sep,61.6,56.9,9640261,8905146,735115,7.6,NY
105,2013,Oct,61.4,56.9,9620358,8902906,717452,7.5,NY
106,2013,Nov,61.3,56.8,9601154,8901935,699219,7.3,NY
107,2013,Dec,61.2,56.8,9583747,8901999,681748,7.1,NY
108,2014,Jan,61.1,56.8,9568507,8903251,665256,7.0,NY
109,2014,Feb,61.0,56.8,9555038,8905204,649834,6.8,NY
110,2014,Mar,60.9,56.8,9543233,8906972,636261,6.7,NY
111,2014,Apr,60.8,56.8,9531922,8907932,623990,6.5,NY
112,2014,May,60.7,56.8,9521136,8909964,611172,6.4,NY
113,2014,Jun,60.6,56.8,9512596,8914743,597853,6.3,NY
114,2014,Jul,60.6,56.8,9506832,8921190,585642,6.2,NY
115,2014,Aug,60.6,56.9,9505320,8929372,575948,6.1,NY
116,2014,Sep,60.6,56.9,9507458,8938865,568593,6.0,NY
117,2014,Oct,60.6,57.0,9510169,8948744,561425,5.9,NY
118,2014,Nov,60.6,57.0,9512399,8958578,553821,5.8,NY
119,2014,Dec,60.6,57.1,9517113,8969792,547321,5.8,NY
120,2015,Jan,60.6,57.2,9524954,8982601,542353,5.7,NY
121,2015,Feb,60.7,57.3,9533927,8995441,538486,5.6,NY
122,2015,Mar,60.7,57.3,9542416,9008594,533822,5.6,NY
123,2015,Apr,60.8,57.4,9548293,9021384,526909,5.5,NY
124,2015,May,60.8,57.5,9549164,9032002,517162,5.4,NY
125,2015,Jun,60.7,57.5,9543550,9038865,504685,5.3,NY
126,2015,Jul,60.7,57.5,9534767,9043435,491332,5.2,NY
127,2015,Aug,60.6,57.6,9527129,9047482,479647,5.0,NY
128,2015,Sep,60.6,57.6,9523717,9053257,470460,4.9,NY
129,2015,Oct,60.6,57.6,9527500,9062751,464749,4.9,NY
130,2015,Nov,60.6,57.7,9537575,9074704,462871,4.9,NY
131,2015,Dec,60.7,57.8,9548386,9085645,462741,4.8,NY
132,2016,Jan,60.8,57.8,9554664,9092379,462285,4.8,NY
133,2016,Feb,60.8,57.8,9553707,9092674,461033,4.8,NY
134,2016,Mar,60.7,57.8,9545384,9086193,459191,4.8,NY
135,2016,Apr,60.6,57.7,9533668,9075462,458206,4.8,NY
136,2016,May,60.6,57.6,9523916,9064157,459759,4.8,NY
137,2016,Jun,60.5,57.6,9518429,9054675,463754,4.9,NY
138,2016,Jul,60.5,57.5,9516807,9048360,468447,4.9,NY
139,2016,Aug,60.5,57.5,9517447,9045264,472183,5.0,NY
140,2016,Sep,60.5,57.5,9518718,9044383,474335,5.0,NY
141,2016,Oct,60.5,57.5,9518573,9045425,473148,5.0,NY
142,2016,Nov,60.5,57.5,9517508,9050218,467290,4.9,NY
143,2016,Dec,60.5,57.6,9518132,9059508,458624,4.8,NY
144,2017,Jan,60.6,57.7,9786877,9326683,460194,4.7,NY
145,2017,Feb,60.7,57.8,9800351,9346626,453725,4.6,NY
146,2017,Mar,60.7,58.0,9817572,9366666,450906,4.6,NY
147,2017,Apr,60.9,58.1,9835869,9384093,451776,4.6,NY
148,2017,May,60.9,58.1,9852683,9398001,454682,4.6,NY
149,2017,Jun,61.0,58.2,9865598,9407322,458276,4.6,NY
150,2017,Jul,61.0,58.2,9872094,9410601,461493,4.7,NY
151,2017,Aug,61.0,58.1,9870248,9407451,462797,4.7,NY
152,2017,Sep,60.9,58.1,9860903,9399265,461638,4.7,NY
153,2017,Oct,60.8,58.0,9846668,9388484,458184,4.7,NY
154,2017,Nov,60.7,57.9,9830847,9377414,453433,4.6,NY
155,2017,Dec,60.6,57.8,9817592,9370967,446625,4.5,NY
156,2018,Jan,60.6,57.9,9811681,9373350,438331,4.5,NY
157,2018,Feb,60.6,57.9,9815682,9386086,429596,4.4,NY
158,2018,Mar,60.6,58.0,9827553,9406848,420705,4.3,NY
159,2018,Apr,60.7,58.2,9840981,9429347,411634,4.2,NY
160,2018,May,60.8,58.3,9849643,9446654,402989,4.1,NY
161,2018,Jun,60.8,58.3,9851785,9456523,395262,4.0,NY
162,2018,Jul,60.7,58.3,9849030,9459881,389149,4.0,NY
163,2018,Aug,60.7,58.3,9845885,9459747,386138,3.9,NY
164,2018,Sep,60.7,58.3,9844431,9457863,386568,3.9,NY
165,2018,Oct,60.7,58.3,9845546,9456826,388720,3.9,NY
166,2018,Nov,60.7,58.3,9849131,9458921,390210,4.0,NY
167,2018,Dec,60.7,58.3,9854208,9464583,389625,4.0,NY
168,2019,Jan,60.7,58.3,9858570,9472023,386547,3.9,NY
169,2019,Feb,60.7,58.4,9860331,9479650,380681,3.9,NY
170,2019,Mar,60.7,58.4,9860362,9486094,374268,3.8,NY
171,2019,Apr,60.7,58.5,9861141,9491920,369221,3.7,NY
172,2019,May,60.8,58.5,9864463,9497238,367225,3.7,NY
173,2019,Jun,60.8,58.5,9870657,9501494,369163,3.7,NY
174,2019,Jul,60.8,58.5,9877987,9503811,374176,3.8,NY
175,2019,Aug,60.9,58.5,9885501,9505846,379655,3.8,NY
176,2019,Sep,60.9,58.6,9895889,9513713,382176,3.9,NY
177,2019,Oct,61.0,58.6,9910497,9527231,383266,3.9,NY
178,2019,Nov,61.1,58.7,9925425,9540945,384480,3.9,NY
179,2019,Dec,61.1,58.8,9932018,9546194,385824,3.9,NY
180,2020,Jan,61.1,58.7,9923921,9537629,386292,3.9,NY
181,2020,Feb,61.0,58.6,9899607,9514153,385454,3.9,NY
182,2020,Mar,60.8,58.4,9864566,9482618,381948,3.9,NY
183,2020,Apr,57.7,48.3,9359206,7839695,1519511,16.2,NY
184,2020,May,58.5,48.9,9494524,7927721,1566803,16.5,NY
185,2020,Jun,59.0,50.9,9562307,8255048,1307259,13.7,NY
186,2020,Jul,59.1,51.6,9578818,8361578,1217240,12.7,NY
187,2020,Aug,58.6,52.1,9483828,8438359,1045469,11.0,NY
188,2020,Sep,58.7,52.6,9483945,8503498,980447,10.3,NY
189,2020,Oct,58.3,52.8,9410966,8533486,877480,9.3,NY
190,2020,Nov,58.3,53.0,9403074,8551035,852039,9.1,NY
191,2020,Dec,58.2,53.1,9382646,8555149,827497,8.8,NY
192,2021,Jan,58.2,53.2,9362929,8554226,808703,8.6,NY
193,2021,Feb,58.2,53.2,9344821,8555836,788985,8.4,NY
194,2021,Mar,59.5,54.8,9548482,8790193,758289,7.9,NY
195,2021,Apr,59.6,54.9,9548857,8804181,744676,7.8,NY
196,2021,May,59.5,55.1,9519849,8817795,702054,7.4,NY
197,2021,Jun,59.6,55.2,9535782,8827869,707913,7.4,NY
198,2021,Jul,59.4,55.3,9487697,8832744,654953,6.9,NY
199,2021,Aug,59.3,55.4,9463499,8837061,626438,6.6,NY
200,2021,Sep,59.0,55.4,9409934,8842284,567650,6.0,NY
201,2021,Oct,58.9,55.6,9385787,8851212,534575,5.7,NY
202,2021,Nov,58.8,55.6,9366160,8856579,509581,5.4,NY
203,2021,Dec,58.9,55.7,9364698,8859312,505386,5.4,NY
204,2022,Jan,59.1,56.0,9386918,8888257,498661,5.3,NY
205,2022,Feb,59.1,56.2,9369054,8910100,458954,4.9,NY
206,2022,Mar,59.1,56.4,9373155,8944494,428661,4.6,NY
207,2022,Apr,59.4,56.7,9404038,8981984,422054,4.5,NY
208,2022,May,59.8,57.2,9456937,9042551,414386,4.4,NY
209,2022,Jun,60.1,57.5,9495213,9078823,416390,4.4,NY
210,2022,Jul,60.3,57.6,9512388,9099038,413350,4.3,NY
211,2022,Aug,60.5,57.7,9542654,9097557,445097,4.7,NY
212,2022,Sep,60.3,57.8,9504907,9100270,404637,4.3,NY
213,2022,Oct,60.5,57.8,9518528,9104956,413572,4.3,NY
214,2022,Nov,60.5,57.9,9517536,9104249,413287,4.3,NY
0,2005,Jan,62.9,59.2,2876208,2710731,165477,5.8,TN
1,2005,Feb,62.8,59.2,2876117,2710274,165843,5.8,TN
2,2005,Mar,62.7,59.1,2877240,2712037,165203,5.7,TN
3,2005,Apr,62.7,59.2,2880139,2716883,163256,5.7,TN
4,2005,May,62.7,59.3,2885126,2724760,160366,5.6,TN
5,2005,Jun,62.8,59.4,2891389,2733867,157522,5.4,TN
6,2005,Jul,62.9,59.5,2897898,2742168,155730,5.4,TN
7,2005,Aug,62.9,59.5,2904849,2749511,155338,5.3,TN
8,2005,Sep,63.0,59.6,2912507,2756425,156082,5.4,TN
9,2005,Oct,63.0,59.6,2920508,2763210,157298,5.4,TN
10,2005,Nov,63.1,59.7,2928930,2770270,158660,5.4,TN
11,2005,Dec,63.2,59.7,2937905,2778144,159761,5.4,TN
12,2006,Jan,63.3,59.9,2948616,2788197,160419,5.4,TN
13,2006,Feb,63.5,60.1,2961842,2800802,161040,5.4,TN
14,2006,Mar,63.7,60.3,2976996,2814715,162281,5.5,TN
15,2006,Apr,64.0,60.5,2993120,2828835,164285,5.5,TN
16,2006,May,64.2,60.7,3008468,2842377,166091,5.5,TN
17,2006,Jun,64.4,60.9,3021272,2854682,166590,5.5,TN
18,2006,Jul,64.5,61.0,3031107,2865935,165172,5.4,TN
19,2006,Aug,64.6,61.2,3038347,2876327,162020,5.3,TN
20,2006,Sep,64.6,61.3,3043505,2885641,157864,5.2,TN
21,2006,Oct,64.6,61.4,3047672,2894538,153134,5.0,TN
22,2006,Nov,64.6,61.5,3050954,2902791,148163,4.9,TN
23,2006,Dec,64.6,61.6,3052604,2909137,143467,4.7,TN
24,2007,Jan,64.5,61.6,3051958,2912489,139469,4.6,TN
25,2007,Feb,64.4,61.5,3049020,2912944,136076,4.5,TN
26,2007,Mar,64.2,61.4,3044434,2911363,133071,4.4,TN
27,2007,Apr,64.0,61.3,3039561,2908711,130850,4.3,TN
28,2007,May,63.9,61.2,3036040,2905735,130305,4.3,TN
29,2007,Jun,63.8,61.0,3035028,2903157,131871,4.3,TN
30,2007,Jul,63.8,60.9,3036405,2900885,135520,4.5,TN
31,2007,Aug,63.7,60.8,3039495,2898731,140764,4.6,TN
32,2007,Sep,63.8,60.7,3043398,2896840,146558,4.8,TN
33,2007,Oct,63.7,60.6,3046663,2894542,152121,5.0,TN
34,2007,Nov,63.7,60.4,3048534,2891923,156611,5.1,TN
35,2007,Dec,63.7,60.3,3049619,2889792,159827,5.2,TN
36,2008,Jan,63.6,60.2,3050278,2887750,162528,5.3,TN
37,2008,Feb,63.6,60.1,3050932,2884998,165934,5.4,TN
38,2008,Mar,63.5,60.0,3052029,2881036,170993,5.6,TN
39,2008,Apr,63.5,59.8,3053781,2875899,177882,5.8,TN
40,2008,May,63.5,59.6,3056689,2870663,186026,6.1,TN
41,2008,Jun,63.5,59.5,3060667,2866212,194455,6.4,TN
42,2008,Jul,63.5,59.3,3064883,2862683,202200,6.6,TN
43,2008,Aug,63.5,59.2,3068290,2859187,209103,6.8,TN
44,2008,Sep,63.5,59.0,3070328,2854164,216164,7.0,TN
45,2008,Oct,63.5,58.8,3070955,2846010,224945,7.3,TN
46,2008,Nov,63.4,58.5,3069508,2832943,236565,7.7,TN
47,2008,Dec,63.3,58.1,3065036,2814331,250705,8.2,TN
48,2009,Jan,63.1,57.6,3057747,2791562,266185,8.7,TN
49,2009,Feb,62.8,57.0,3049266,2767661,281605,9.2,TN
50,2009,Mar,62.6,56.6,3041270,2746230,295040,9.7,TN
51,2009,Apr,62.5,56.2,3034647,2729517,305130,10.1,TN
52,2009,May,62.3,55.9,3029350,2717680,311670,10.3,TN
53,2009,Jun,62.2,55.7,3025629,2710361,315268,10.4,TN
54,2009,Jul,62.1,55.6,3023463,2706513,316950,10.5,TN
55,2009,Aug,62.0,55.5,3022770,2705032,317738,10.5,TN
56,2009,Sep,62.0,55.5,3023659,2705490,318169,10.5,TN
57,2009,Oct,62.0,55.4,3025771,2707285,318486,10.5,TN
58,2009,Nov,62.0,55.5,3030297,2711254,319043,10.5,TN
59,2009,Dec,62.1,55.6,3038713,2718884,319829,10.5,TN
60,2010,Jan,62.3,55.8,3050578,2730789,319789,10.5,TN
61,2010,Feb,62.6,56.1,3063620,2745903,317717,10.4,TN
62,2010,Mar,62.8,56.4,3076129,2762469,313660,10.2,TN
63,2010,Apr,62.8,56.5,3087199,2778857,308342,10.0,TN
64,2010,May,62.9,56.8,3096008,2793510,302498,9.8,TN
65,2010,Jun,63.0,56.9,3101945,2804364,297581,9.6,TN
66,2010,Jul,63.0,57.0,3105034,2810185,294849,9.5,TN
67,2010,Aug,62.9,57.0,3105998,2811416,294582,9.5,TN
68,2010,Sep,62.9,56.9,3105987,2809706,296281,9.5,TN
69,2010,Oct,62.8,56.8,3106786,2808210,298576,9.6,TN
70,2010,Nov,62.8,56.8,3109113,2809060,300053,9.7,TN
71,2010,Dec,62.9,56.8,3112714,2812682,300032,9.6,TN
72,2011,Jan,62.9,56.9,3117268,2818458,298810,9.6,TN
73,2011,Feb,63.0,57.0,3121614,2824825,296789,9.5,TN
74,2011,Mar,63.0,57.1,3124286,2830057,294229,9.4,TN
75,2011,Apr,63.0,57.1,3124721,2832937,291784,9.3,TN
76,2011,May,62.9,57.0,3123434,2833384,290050,9.3,TN
77,2011,Jun,62.8,57.0,3121176,2832604,288572,9.2,TN
78,2011,Jul,62.7,56.9,3118930,2832382,286548,9.2,TN
79,2011,Aug,62.6,56.9,3116910,2833535,283375,9.1,TN
80,2011,Sep,62.5,56.9,3114511,2835806,278705,8.9,TN
81,2011,Oct,62.4,56.9,3111419,2838553,272866,8.8,TN
82,2011,Nov,62.3,56.9,3107219,2840913,266306,8.6,TN
83,2011,Dec,62.1,56.9,3101996,2842262,259734,8.4,TN
84,2012,Jan,62.0,56.9,3097157,2843050,254107,8.2,TN
85,2012,Feb,61.8,56.8,3094096,2843731,250365,8.1,TN
86,2012,Mar,61.8,56.8,3092834,2843922,248912,8.0,TN
87,2012,Apr,61.7,56.8,3092229,2843514,248715,8.0,TN
88,2012,May,61.7,56.7,3092082,2843398,248684,8.0,TN
89,2012,Jun,61.6,56.7,3092371,2844370,248001,8.0,TN
90,2012,Jul,61.6,56.7,3093294,2847096,246198,8.0,TN
91,2012,Aug,61.6,56.7,3095301,2851322,243979,7.9,TN
92,2012,Sep,61.6,56.8,3098402,2855937,242465,7.8,TN
93,2012,Oct,61.6,56.8,3101365,2859257,242108,7.8,TN
94,2012,Nov,61.6,56.8,3103321,2860286,243035,7.8,TN
95,2012,Dec,61.6,56.7,3103871,2859008,244863,7.9,TN
96,2013,Jan,61.5,56.6,3102423,2855543,246880,8.0,TN
97,2013,Feb,61.4,56.5,3099418,2851148,248270,8.0,TN
98,2013,Mar,61.3,56.4,3095898,2847593,248305,8.0,TN
99,2013,Apr,61.2,56.3,3092912,2845925,246987,8.0,TN
100,2013,May,61.1,56.2,3089865,2844913,244952,7.9,TN
101,2013,Jun,61.0,56.2,3085954,2843190,242764,7.9,TN
102,2013,Jul,60.8,56.1,3080892,2840265,240627,7.8,TN
103,2013,Aug,60.6,56.0,3074336,2836800,237536,7.7,TN
104,2013,Sep,60.4,55.9,3066803,2833931,232872,7.6,TN
105,2013,Oct,60.3,55.8,3059810,2832394,227416,7.4,TN
106,2013,Nov,60.1,55.7,3054206,2832369,221837,7.3,TN
107,2013,Dec,60.0,55.7,3049904,2833383,216521,7.1,TN
108,2014,Jan,59.9,55.7,3046560,2834891,211669,6.9,TN
109,2014,Feb,59.8,55.7,3043669,2835964,207705,6.8,TN
110,2014,Mar,59.7,55.7,3041048,2835726,205322,6.8,TN
111,2014,Apr,59.6,55.6,3038521,2834046,204475,6.7,TN
112,2014,May,59.5,55.5,3036563,2832484,204079,6.7,TN
113,2014,Jun,59.5,55.5,3036228,2832894,203334,6.7,TN
114,2014,Jul,59.4,55.5,3037420,2835451,201969,6.6,TN
115,2014,Aug,59.4,55.5,3040492,2840279,200213,6.6,TN
116,2014,Sep,59.5,55.6,3045235,2846964,198271,6.5,TN
117,2014,Oct,59.5,55.7,3049884,2854160,195724,6.4,TN
118,2014,Nov,59.5,55.8,3052910,2860333,192577,6.3,TN
119,2014,Dec,59.5,55.8,3054766,2865175,189591,6.2,TN
120,2015,Jan,59.5,55.9,3056389,2869136,187253,6.1,TN
121,2015,Feb,59.5,55.9,3058800,2873342,185458,6.1,TN
122,2015,Mar,59.5,56.0,3062426,2878956,183470,6.0,TN
123,2015,Apr,59.6,56.1,3066692,2885754,180938,5.9,TN
124,2015,May,59.6,56.2,3070773,2892935,177838,5.8,TN
125,2015,Jun,59.6,56.2,3073789,2899547,174242,5.7,TN
126,2015,Jul,59.6,56.3,3075793,2905360,170433,5.5,TN
127,2015,Aug,59.6,56.4,3077329,2910795,166534,5.4,TN
128,2015,Sep,59.6,56.4,3079250,2916889,162361,5.3,TN
129,2015,Oct,59.6,56.5,3083238,2925088,158150,5.1,TN
130,2015,Nov,59.7,56.7,3090043,2935651,154392,5.0,TN
131,2015,Dec,59.8,56.8,3098156,2947080,151076,4.9,TN
132,2016,Jan,59.9,57.0,3105686,2957506,148180,4.8,TN
133,2016,Feb,59.9,57.1,3111657,2965602,146055,4.7,TN
134,2016,Mar,60.0,57.2,3116195,2971290,144905,4.7,TN
135,2016,Apr,60.0,57.2,3120756,2975759,144997,4.6,TN
136,2016,May,60.1,57.2,3126578,2980257,146321,4.7,TN
137,2016,Jun,60.1,57.3,3133742,2985440,148302,4.7,TN
138,2016,Jul,60.2,57.4,3141665,2991411,150254,4.8,TN
139,2016,Aug,60.3,57.4,3148996,2997016,151980,4.8,TN
140,2016,Sep,60.4,57.4,3154762,3001280,153482,4.9,TN
141,2016,Oct,60.4,57.4,3158441,3004295,154146,4.9,TN
142,2016,Nov,60.4,57.4,3160471,3007297,153174,4.8,TN
143,2016,Dec,60.3,57.5,3161953,3011886,150067,4.7,TN
144,2017,Jan,60.3,57.6,3171747,3026155,145592,4.6,TN
145,2017,Feb,60.3,57.7,3175086,3035834,139252,4.4,TN
146,2017,Mar,60.4,57.9,3179214,3047101,132113,4.2,TN
147,2017,Apr,60.4,58.0,3184140,3059223,124917,3.9,TN
148,2017,May,60.5,58.2,3189735,3071352,118383,3.7,TN
149,2017,Jun,60.5,58.4,3195545,3082091,113454,3.6,TN
150,2017,Jul,60.6,58.5,3201412,3090836,110576,3.5,TN
151,2017,Aug,60.6,58.5,3206644,3097281,109363,3.4,TN
152,2017,Sep,60.6,58.5,3210372,3101083,109289,3.4,TN
153,2017,Oct,60.6,58.5,3212576,3102731,109845,3.4,TN
154,2017,Nov,60.6,58.5,3214155,3103452,110703,3.4,TN
155,2017,Dec,60.5,58.4,3216562,3105014,111548,3.5,TN
156,2018,Jan,60.6,58.5,3221534,3109126,112408,3.5,TN
157,2018,Feb,60.7,58.6,3229914,3116778,113136,3.5,TN
158,2018,Mar,60.8,58.7,3240494,3126924,113570,3.5,TN
159,2018,Apr,61.0,58.9,3250511,3136783,113728,3.5,TN
160,2018,May,61.1,58.9,3258091,3144161,113930,3.5,TN
161,2018,Jun,61.1,59.0,3263491,3149229,114262,3.5,TN
162,2018,Jul,61.1,59.0,3266891,3152360,114531,3.5,TN
163,2018,Aug,61.1,59.0,3269631,3154823,114808,3.5,TN
164,2018,Sep,61.1,59.0,3273371,3158358,115013,3.5,TN
165,2018,Oct,61.2,59.0,3279033,3164021,115012,3.5,TN
166,2018,Nov,61.3,59.1,3286913,3172159,114754,3.5,TN
167,2018,Dec,61.4,59.3,3297048,3182624,114424,3.5,TN
168,2019,Jan,61.6,59.5,3308604,3194388,114216,3.5,TN
169,2019,Feb,61.8,59.6,3319907,3205914,113993,3.4,TN
170,2019,Mar,61.9,59.8,3329729,3216162,113567,3.4,TN
171,2019,Apr,62.0,59.9,3337793,3225201,112592,3.4,TN
172,2019,May,62.1,60.0,3343491,3232261,111230,3.3,TN
173,2019,Jun,62.0,60.0,3346256,3236155,110101,3.3,TN
174,2019,Jul,62.0,60.0,3346647,3236704,109943,3.3,TN
175,2019,Aug,61.9,59.9,3346068,3235116,110952,3.3,TN
176,2019,Sep,61.9,59.8,3346552,3233889,112663,3.4,TN
177,2019,Oct,61.8,59.7,3348932,3233914,115018,3.4,TN
178,2019,Nov,61.8,59.7,3351835,3234406,117429,3.5,TN
179,2019,Dec,61.8,59.6,3352018,3232959,119059,3.6,TN
180,2020,Jan,61.6,59.4,3347257,3227947,119310,3.6,TN
181,2020,Feb,61.4,59.2,3338124,3218843,119281,3.6,TN
182,2020,Mar,61.2,59.0,3327219,3206971,120248,3.6,TN
183,2020,Apr,59.0,49.6,3211554,2701073,510481,15.9,TN
184,2020,May,60.0,52.8,3268122,2873669,394453,12.1,TN
185,2020,Jun,59.8,53.8,3260269,2932152,328117,10.1,TN
186,2020,Jul,60.1,54.8,3277828,2989540,288288,8.8,TN
187,2020,Aug,60.1,55.6,3282374,3037425,244949,7.5,TN
188,2020,Sep,60.6,56.3,3309009,3079361,229648,6.9,TN
189,2020,Oct,60.5,56.8,3311852,3108454,203398,6.1,TN
190,2020,Nov,60.6,57.1,3317441,3127258,190183,5.7,TN
191,2020,Dec,60.6,57.3,3318929,3137768,181161,5.5,TN
192,2021,Jan,60.5,57.3,3314626,3142669,171957,5.2,TN
193,2021,Feb,60.4,57.3,3312632,3146330,166302,5.0,TN
194,2021,Mar,60.4,57.4,3314337,3152453,161884,4.9,TN
195,2021,Apr,60.4,57.5,3319366,3161329,158037,4.8,TN
196,2021,May,60.5,57.7,3324202,3172170,152032,4.6,TN
197,2021,Jun,60.5,57.8,3329467,3182243,147224,4.4,TN
198,2021,Jul,60.5,57.9,3331970,3191864,140106,4.2,TN
199,2021,Aug,60.4,58.0,3333606,3200554,133052,4.0,TN
200,2021,Sep,60.4,58.1,3335317,3208956,126361,3.8,TN
201,2021,Oct,60.4,58.2,3338298,3216223,122075,3.7,TN
202,2021,Nov,60.3,58.1,3339185,3219058,120127,3.6,TN
203,2021,Dec,60.3,58.1,3339846,3220022,119824,3.6,TN
204,2022,Jan,60.3,58.2,3346464,3229716,116748,3.5,TN
205,2022,Feb,60.4,58.4,3356786,3242915,113871,3.4,TN
206,2022,Mar,60.6,58.7,3370646,3261628,109018,3.2,TN
207,2022,Apr,60.9,58.9,3388428,3278866,109562,3.2,TN
208,2022,May,61.1,59.1,3405540,3293587,111953,3.3,TN
209,2022,Jun,61.2,59.2,3413336,3299492,113844,3.3,TN
210,2022,Jul,61.1,59.0,3409644,3295558,114086,3.3,TN
211,2022,Aug,60.8,58.7,3399015,3284336,114679,3.4,TN
212,2022,Sep,60.5,58.4,3385971,3271534,114437,3.4,TN
213,2022,Oct,60.1,58.0,3368279,3251766,116513,3.5,TN
214,2022,Nov,59.6,57.5,3346049,3227707,118342,3.5,TN
0,2005,Jan,68.0,65.3,3850656,3699201,151455,3.9,VA
1,2005,Feb,68.1,65.4,3861571,3709239,152332,3.9,VA
2,2005,Mar,68.2,65.5,3873810,3720949,152861,3.9,VA
3,2005,Apr,68.4,65.7,3887264,3734204,153060,3.9,VA
4,2005,May,68.5,65.8,3901019,3748057,152962,3.9,VA
5,2005,Jun,68.6,66.0,3913106,3760577,152529,3.9,VA
6,2005,Jul,68.7,66.0,3922403,3770468,151935,3.9,VA
7,2005,Aug,68.7,66.1,3928582,3777612,150970,3.8,VA
8,2005,Sep,68.7,66.1,3932245,3782825,149420,3.8,VA
9,2005,Oct,68.6,66.0,3934813,3787789,147024,3.7,VA
10,2005,Nov,68.6,66.1,3937586,3793610,143976,3.7,VA
11,2005,Dec,68.5,66.1,3940662,3800223,140439,3.6,VA
12,2006,Jan,68.5,66.2,3944531,3807796,136735,3.5,VA
13,2006,Feb,68.5,66.2,3949380,3815798,133582,3.4,VA
14,2006,Mar,68.6,66.3,3954870,3823250,131620,3.3,VA
15,2006,Apr,68.6,66.3,3960510,3829433,131077,3.3,VA
16,2006,May,68.6,66.4,3965991,3834431,131560,3.3,VA
17,2006,Jun,68.6,66.4,3971300,3838785,132515,3.3,VA
18,2006,Jul,68.7,66.4,3976954,3843635,133319,3.4,VA
19,2006,Aug,68.7,66.4,3983653,3849897,133756,3.4,VA
20,2006,Sep,68.8,66.5,3991266,3857489,133777,3.4,VA
21,2006,Oct,68.8,66.5,3999235,3866151,133084,3.3,VA
22,2006,Nov,68.9,66.6,4006703,3874981,131722,3.3,VA
23,2006,Dec,68.9,66.7,4012705,3882705,130000,3.2,VA
24,2007,Jan,68.9,66.7,4016723,3888251,128472,3.2,VA
25,2007,Feb,68.9,66.7,4019179,3891877,127302,3.2,VA
26,2007,Mar,68.9,66.7,4020557,3894124,126433,3.1,VA
27,2007,Apr,68.8,66.7,4021773,3895919,125854,3.1,VA
28,2007,May,68.8,66.7,4023984,3898080,125904,3.1,VA
29,2007,Jun,68.8,66.6,4028150,3901236,126914,3.2,VA
30,2007,Jul,68.8,66.6,4034464,3905389,129075,3.2,VA
31,2007,Aug,68.9,66.7,4042707,3910208,132499,3.3,VA
32,2007,Sep,69.0,66.7,4052349,3915752,136597,3.4,VA
33,2007,Oct,69.1,66.7,4062269,3921492,140777,3.5,VA
34,2007,Nov,69.2,66.7,4071799,3927530,144269,3.5,VA
35,2007,Dec,69.3,66.8,4081055,3934313,146742,3.6,VA
36,2008,Jan,69.4,66.8,4089713,3941102,148611,3.6,VA
37,2008,Feb,69.5,66.9,4097974,3947359,150615,3.7,VA
38,2008,Mar,69.5,66.9,4106722,3952938,153784,3.7,VA
39,2008,Apr,69.6,67.0,4116032,3957470,158562,3.9,VA
40,2008,May,69.7,66.9,4125461,3960901,164560,4.0,VA
41,2008,Jun,69.8,66.9,4134305,3963346,170959,4.1,VA
42,2008,Jul,69.9,66.9,4141385,3964430,176955,4.3,VA
43,2008,Aug,69.9,66.8,4145890,3963418,182472,4.4,VA
44,2008,Sep,69.8,66.6,4147911,3959244,188667,4.5,VA
45,2008,Oct,69.7,66.4,4148057,3951093,196964,4.7,VA
46,2008,Nov,69.6,66.1,4146700,3938595,208105,5.0,VA
47,2008,Dec,69.5,65.8,4144520,3922612,221908,5.4,VA
48,2009,Jan,69.4,65.4,4142432,3905221,237211,5.7,VA
49,2009,Feb,69.3,65.1,4141054,3888770,252284,6.1,VA
50,2009,Mar,69.3,64.8,4140763,3875758,265005,6.4,VA
51,2009,Apr,69.2,64.6,4141347,3867062,274285,6.6,VA
52,2009,May,69.1,64.5,4141603,3861057,280546,6.8,VA
53,2009,Jun,69.1,64.3,4140712,3855929,284783,6.9,VA
54,2009,Jul,68.9,64.1,4138354,3850155,288199,7.0,VA
55,2009,Aug,68.8,63.9,4134913,3843174,291739,7.1,VA
56,2009,Sep,68.7,63.7,4131421,3835560,295861,7.2,VA
57,2009,Oct,68.5,63.5,4128934,3828154,300780,7.3,VA
58,2009,Nov,68.5,63.4,4129176,3822838,306338,7.4,VA
59,2009,Dec,68.5,63.3,4132983,3821237,311746,7.5,VA
60,2010,Jan,68.5,63.3,4139523,3823909,315614,7.6,VA
61,2010,Feb,68.6,63.3,4146809,3829743,317066,7.6,VA
62,2010,Mar,68.6,63.4,4153490,3837310,316180,7.6,VA
63,2010,Apr,67.6,62.5,4159068,3845699,313369,7.5,VA
64,2010,May,67.6,62.6,4163253,3854150,309103,7.4,VA
65,2010,Jun,67.6,62.7,4165768,3861060,304708,7.3,VA
66,2010,Jul,67.6,62.7,4167097,3865710,301387,7.2,VA
67,2010,Aug,67.5,62.6,4168162,3868904,299258,7.2,VA
68,2010,Sep,67.4,62.6,4169589,3871974,297615,7.1,VA
69,2010,Oct,67.4,62.6,4172079,3876726,295353,7.1,VA
70,2010,Nov,67.4,62.7,4175447,3883599,291848,7.0,VA
71,2010,Dec,67.4,62.7,4179321,3892116,287205,6.9,VA
72,2011,Jan,67.4,62.8,4183595,3901342,282253,6.7,VA
73,2011,Feb,67.4,62.9,4187549,3909662,277887,6.6,VA
74,2011,Mar,67.4,62.9,4189997,3915249,274748,6.6,VA
75,2011,Apr,67.3,62.9,4191359,3917774,273585,6.5,VA
76,2011,May,67.3,62.9,4193417,3918828,274589,6.5,VA
77,2011,Jun,67.3,62.8,4197326,3920664,276662,6.6,VA
78,2011,Jul,67.3,62.8,4203699,3925109,278590,6.6,VA
79,2011,Aug,67.4,62.9,4211579,3932076,279503,6.6,VA
80,2011,Sep,67.4,62.9,4219107,3940336,278771,6.6,VA
81,2011,Oct,67.4,63.0,4224836,3948490,276346,6.5,VA
82,2011,Nov,67.4,63.0,4227390,3954876,272514,6.4,VA
83,2011,Dec,67.3,63.0,4226121,3958263,267858,6.3,VA
84,2012,Jan,67.2,63.0,4222321,3959095,263226,6.2,VA
85,2012,Feb,67.0,62.9,4218049,3958507,259542,6.2,VA
86,2012,Mar,66.9,62.8,4214269,3956965,257304,6.1,VA
87,2012,Apr,66.8,62.7,4210876,3954894,255982,6.1,VA
88,2012,May,66.7,62.7,4208645,3953818,254827,6.1,VA
89,2012,Jun,66.6,62.6,4208558,3955368,253190,6.0,VA
90,2012,Jul,66.6,62.6,4210712,3960179,250533,5.9,VA
91,2012,Aug,66.6,62.7,4215085,3967765,247320,5.9,VA
92,2012,Sep,66.6,62.8,4221076,3976567,244509,5.8,VA
93,2012,Oct,66.7,62.8,4226595,3984368,242227,5.7,VA
94,2012,Nov,66.7,62.9,4230245,3989727,240518,5.7,VA
95,2012,Dec,66.6,62.9,4231663,3992299,239364,5.7,VA
96,2013,Jan,66.6,62.8,4230986,3992211,238775,5.6,VA
97,2013,Feb,66.5,62.7,4229626,3991100,238526,5.6,VA
98,2013,Mar,66.5,62.7,4229584,3991308,238276,5.6,VA
99,2013,Apr,66.4,62.7,4232119,3994223,237896,5.6,VA
100,2013,May,66.4,62.7,4236152,3998446,237706,5.6,VA
101,2013,Jun,66.5,62.7,4240224,4002240,237984,5.6,VA
102,2013,Jul,66.5,62.7,4243322,4005011,238311,5.6,VA
103,2013,Aug,66.4,62.7,4244602,4007012,237590,5.6,VA
104,2013,Sep,66.4,62.7,4244434,4009047,235387,5.5,VA
105,2013,Oct,66.3,62.7,4244667,4011855,232812,5.5,VA
106,2013,Nov,66.3,62.7,4246742,4016111,230631,5.4,VA
107,2013,Dec,66.3,62.7,4250846,4021840,229006,5.4,VA
108,2014,Jan,66.3,62.8,4256299,4028612,227687,5.3,VA
109,2014,Feb,66.4,62.9,4261740,4035391,226349,5.3,VA
110,2014,Mar,66.4,62.9,4265948,4040682,225266,5.3,VA
111,2014,Apr,66.4,62.9,4267774,4043315,224459,5.3,VA
112,2014,May,66.3,62.9,4267161,4043979,223182,5.2,VA
113,2014,Jun,66.3,62.8,4265150,4044124,221026,5.2,VA
114,2014,Jul,66.1,62.8,4261973,4043653,218320,5.1,VA
115,2014,Aug,66.0,62.7,4258573,4043065,215508,5.1,VA
116,2014,Sep,65.9,62.6,4255711,4042931,212780,5.0,VA
117,2014,Oct,65.8,62.6,4252749,4042841,209908,4.9,VA
118,2014,Nov,65.7,62.5,4249011,4042113,206898,4.9,VA
119,2014,Dec,65.6,62.5,4245503,4041135,204368,4.8,VA
120,2015,Jan,65.6,62.4,4242711,4040145,202566,4.8,VA
121,2015,Feb,65.5,62.4,4240767,4039464,201303,4.7,VA
122,2015,Mar,65.4,62.4,4239843,4040318,199525,4.7,VA
123,2015,Apr,65.4,62.4,4239190,4042765,196425,4.6,VA
124,2015,May,65.3,62.4,4237686,4045613,192073,4.5,VA
125,2015,Jun,65.2,62.3,4234686,4047714,186972,4.4,VA
126,2015,Jul,65.1,62.3,4231177,4049219,181958,4.3,VA
127,2015,Aug,65.0,62.3,4227968,4050212,177756,4.2,VA
128,2015,Sep,64.9,62.3,4225421,4050900,174521,4.1,VA
129,2015,Oct,64.9,62.3,4224998,4052719,172279,4.1,VA
130,2015,Nov,64.9,62.3,4227185,4056317,170868,4.0,VA
131,2015,Dec,64.9,62.3,4230228,4060702,169526,4.0,VA
132,2016,Jan,64.9,62.3,4232843,4065106,167737,4.0,VA
133,2016,Feb,64.9,62.3,4234522,4068700,165822,3.9,VA
134,2016,Mar,64.9,62.4,4235332,4070935,164397,3.9,VA
135,2016,Apr,64.9,62.4,4236772,4072587,164185,3.9,VA
136,2016,May,64.9,62.4,4240409,4074927,165482,3.9,VA
137,2016,Jun,64.9,62.4,4246189,4078270,167919,4.0,VA
138,2016,Jul,65.0,62.4,4253358,4082681,170677,4.0,VA
139,2016,Aug,65.1,62.4,4261151,4088025,173126,4.1,VA
140,2016,Sep,65.1,62.5,4269034,4094058,174976,4.1,VA
141,2016,Oct,65.2,62.5,4276217,4100496,175721,4.1,VA
142,2016,Nov,65.2,62.6,4283055,4107886,175169,4.1,VA
143,2016,Dec,65.3,62.7,4290653,4116919,173734,4.0,VA
144,2017,Jan,65.4,62.8,4318562,4144568,173994,4.0,VA
145,2017,Feb,65.6,63.0,4329575,4157544,172031,4.0,VA
146,2017,Mar,65.7,63.1,4339507,4170194,169313,3.9,VA
147,2017,Apr,65.7,63.2,4347838,4181768,166070,3.8,VA
148,2017,May,65.8,63.3,4354662,4192147,162515,3.7,VA
149,2017,Jun,65.8,63.4,4359665,4200505,159160,3.7,VA
150,2017,Jul,65.8,63.5,4362829,4206323,156506,3.6,VA
151,2017,Aug,65.8,63.5,4364018,4209550,154468,3.5,VA
152,2017,Sep,65.7,63.4,4363693,4210984,152709,3.5,VA
153,2017,Oct,65.7,63.4,4362892,4211968,150924,3.5,VA
154,2017,Nov,65.7,63.4,4362552,4213541,149011,3.4,VA
155,2017,Dec,65.6,63.4,4364128,4217312,146816,3.4,VA
156,2018,Jan,65.7,63.5,4368698,4224313,144385,3.3,VA
157,2018,Feb,65.8,63.6,4376237,4234740,141497,3.2,VA
158,2018,Mar,65.9,63.8,4384496,4246774,137722,3.1,VA
159,2018,Apr,65.9,63.9,4389539,4256496,133043,3.0,VA
160,2018,May,65.9,64.0,4389088,4260902,128186,2.9,VA
161,2018,Jun,65.8,63.9,4384613,4260628,123985,2.8,VA
162,2018,Jul,65.6,63.8,4378726,4257711,121015,2.8,VA
163,2018,Aug,65.5,63.7,4374959,4254879,120080,2.7,VA
164,2018,Sep,65.5,63.7,4375977,4254401,121576,2.8,VA
165,2018,Oct,65.6,63.7,4382699,4257735,124964,2.9,VA
166,2018,Nov,65.7,63.8,4394158,4265195,128963,2.9,VA
167,2018,Dec,65.9,63.9,4408593,4275950,132643,3.0,VA
168,2019,Jan,66.0,64.0,4423237,4288349,134888,3.0,VA
169,2019,Feb,66.2,64.2,4435608,4300991,134617,3.0,VA
170,2019,Mar,66.3,64.3,4444106,4312608,131498,3.0,VA
171,2019,Apr,66.3,64.4,4448783,4322634,126149,2.8,VA
172,2019,May,66.3,64.5,4450633,4330431,120202,2.7,VA
173,2019,Jun,66.3,64.6,4451439,4335880,115559,2.6,VA
174,2019,Jul,66.3,64.6,4452963,4339329,113634,2.6,VA
175,2019,Aug,66.3,64.6,4456631,4342107,114524,2.6,VA
176,2019,Sep,66.3,64.6,4463234,4346413,116821,2.6,VA
177,2019,Oct,66.4,64.6,4471359,4352179,119180,2.7,VA
178,2019,Nov,66.5,64.7,4478423,4358050,120373,2.7,VA
179,2019,Dec,66.4,64.7,4479922,4360555,119367,2.7,VA
180,2020,Jan,66.3,64.6,4476110,4358002,118108,2.6,VA
181,2020,Feb,66.3,64.5,4472102,4351486,120616,2.7,VA
182,2020,Mar,66.3,64.4,4475224,4346203,129021,2.9,VA
183,2020,Apr,65.7,58.1,4438368,3923996,514372,11.6,VA
184,2020,May,64.5,58.4,4360022,3942454,417568,9.6,VA
185,2020,Jun,64.1,58.7,4331562,3964356,367206,8.5,VA
186,2020,Jul,64.2,59.2,4341747,3999123,342624,7.9,VA
187,2020,Aug,64.0,59.5,4329004,4026641,302363,7.0,VA
188,2020,Sep,63.9,59.9,4325042,4050998,274044,6.3,VA
189,2020,Oct,63.6,60.0,4302708,4061102,241606,5.6,VA
190,2020,Nov,63.3,60.1,4288791,4066868,221923,5.2,VA
191,2020,Dec,63.2,60.1,4281135,4068950,212185,5.0,VA
192,2021,Jan,63.1,60.1,4273026,4070041,202985,4.8,VA
193,2021,Feb,63.0,60.1,4269666,4072592,197074,4.6,VA
194,2021,Mar,63.0,60.2,4271368,4079907,191461,4.5,VA
195,2021,Apr,63.0,60.3,4271495,4087031,184464,4.3,VA
196,2021,May,63.0,60.4,4269959,4093462,176497,4.1,VA
197,2021,Jun,62.9,60.4,4265672,4096488,169184,4.0,VA
198,2021,Jul,62.8,60.4,4259200,4098902,160298,3.8,VA
199,2021,Aug,62.7,60.5,4257595,4104689,152906,3.6,VA
200,2021,Sep,62.7,60.5,4256874,4110238,146636,3.4,VA
201,2021,Oct,62.7,60.6,4261352,4118511,142841,3.4,VA
202,2021,Nov,62.7,60.6,4261974,4120445,141529,3.3,VA
203,2021,Dec,62.6,60.6,4261296,4120143,141153,3.3,VA
204,2022,Jan,62.9,60.8,4277852,4138518,139334,3.3,VA
205,2022,Feb,63.0,61.0,4292097,4156074,136023,3.2,VA
206,2022,Mar,63.3,61.4,4311626,4180531,131095,3.0,VA
207,2022,Apr,63.5,61.6,4330002,4200202,129800,3.0,VA
208,2022,May,63.8,61.9,4347215,4218400,128815,3.0,VA
209,2022,Jun,63.9,62.1,4355189,4232269,122920,2.8,VA
210,2022,Jul,63.8,62.1,4354000,4237941,116059,2.7,VA
211,2022,Aug,63.7,62.0,4346828,4232723,114105,2.6,VA
212,2022,Sep,63.6,62.0,4346910,4233694,113216,2.6,VA
213,2022,Oct,63.6,61.9,4348074,4231191,116883,2.7,VA
214,2022,Nov,63.6,61.7,4347555,4223765,123790,2.8,VA
0,2005,Jan,66.6,63.7,481501,460719,20782,4.3,MT
1,2005,Feb,66.6,63.7,481942,461273,20669,4.3,MT
2,2005,Mar,66.5,63.7,482380,461878,20502,4.3,MT
3,2005,Apr,66.6,63.8,482966,462673,20293,4.2,MT
4,2005,May,66.6,63.8,483804,463742,20062,4.1,MT
5,2005,Jun,66.7,63.9,484873,465024,19849,4.1,MT
6,2005,Jul,66.7,64.0,486068,466344,19724,4.1,MT
7,2005,Aug,66.8,64.1,487195,467581,19614,4.0,MT
8,2005,Sep,66.8,64.2,488098,468695,19403,4.0,MT
9,2005,Oct,66.8,64.2,488697,469654,19043,3.9,MT
10,2005,Nov,66.7,64.2,489065,470489,18576,3.8,MT
11,2005,Dec,66.7,64.2,489365,471289,18076,3.7,MT
12,2006,Jan,66.7,64.3,489832,472225,17607,3.6,MT
13,2006,Feb,66.7,64.4,490715,473484,17231,3.5,MT
14,2006,Mar,66.8,64.5,492075,475078,16997,3.5,MT
15,2006,Apr,67.0,64.7,493679,476780,16899,3.4,MT
16,2006,May,67.1,64.8,495157,478285,16872,3.4,MT
17,2006,Jun,67.1,64.9,496176,479335,16841,3.4,MT
18,2006,Jul,67.1,64.9,496676,479942,16734,3.4,MT
19,2006,Aug,67.1,64.8,496874,480340,16534,3.3,MT
20,2006,Sep,67.0,64.8,497008,480753,16255,3.3,MT
21,2006,Oct,66.9,64.8,497327,481487,15840,3.2,MT
22,2006,Nov,66.9,64.9,498025,482717,15308,3.1,MT
23,2006,Dec,67.0,65.0,499089,484328,14761,3.0,MT
24,2007,Jan,67.1,65.2,500327,485966,14361,2.9,MT
25,2007,Feb,67.2,65.3,501476,487228,14248,2.8,MT
26,2007,Mar,67.2,65.3,502396,487908,14488,2.9,MT
27,2007,Apr,67.3,65.2,503141,488072,15069,3.0,MT
28,2007,May,67.3,65.1,503837,487924,15913,3.2,MT
29,2007,Jun,67.3,65.0,504589,487728,16861,3.3,MT
30,2007,Jul,67.3,64.9,505402,487649,17753,3.5,MT
31,2007,Aug,67.3,64.9,506257,487785,18472,3.6,MT
32,2007,Sep,67.4,64.9,507153,488205,18948,3.7,MT
33,2007,Oct,67.4,64.9,508080,488870,19210,3.8,MT
34,2007,Nov,67.5,64.9,508950,489629,19321,3.8,MT
35,2007,Dec,67.5,64.9,509732,490367,19365,3.8,MT
36,2008,Jan,67.5,64.9,510364,490873,19491,3.8,MT
37,2008,Feb,67.5,64.9,510816,491021,19795,3.9,MT
38,2008,Mar,67.5,64.8,511130,490799,20331,4.0,MT
39,2008,Apr,67.5,64.7,511411,490311,21100,4.1,MT
40,2008,May,67.4,64.5,511776,489740,22036,4.3,MT
41,2008,Jun,67.4,64.4,512294,489229,23065,4.5,MT
42,2008,Jul,67.4,64.3,512944,488842,24102,4.7,MT
43,2008,Aug,67.5,64.2,513563,488397,25166,4.9,MT
44,2008,Sep,67.4,64.0,513902,487527,26375,5.1,MT
45,2008,Oct,67.4,63.7,513700,485834,27866,5.4,MT
46,2008,Nov,67.2,63.3,512832,483179,29653,5.8,MT
47,2008,Dec,67.0,62.8,511355,479767,31588,6.2,MT
48,2009,Jan,66.7,62.3,509478,476051,33427,6.6,MT
49,2009,Feb,66.4,61.8,507574,472644,34930,6.9,MT
50,2009,Mar,66.1,61.4,505944,470036,35908,7.1,MT
51,2009,Apr,65.9,61.2,504683,468374,36309,7.2,MT
52,2009,May,65.7,61.0,503645,467389,36256,7.2,MT
53,2009,Jun,65.6,60.9,502704,466739,35965,7.2,MT
54,2009,Jul,65.4,60.7,501734,466047,35687,7.1,MT
55,2009,Aug,65.2,60.6,500707,465128,35579,7.1,MT
56,2009,Sep,65.0,60.4,499791,464097,35694,7.1,MT
57,2009,Oct,64.9,60.2,499149,463140,36009,7.2,MT
58,2009,Nov,64.8,60.1,498984,462518,36466,7.3,MT
59,2009,Dec,64.8,60.0,499358,462376,36982,7.4,MT
60,2010,Jan,64.9,60.1,500111,462743,37368,7.5,MT
61,2010,Feb,65.0,60.1,500923,463419,37504,7.5,MT
62,2010,Mar,65.0,60.2,501546,464199,37347,7.4,MT
63,2010,Apr,64.6,59.8,501897,464966,36931,7.4,MT
64,2010,May,64.5,59.9,501975,465645,36330,7.2,MT
65,2010,Jun,64.5,59.9,501750,466046,35704,7.1,MT
66,2010,Jul,64.4,59.9,501304,466066,35238,7.0,MT
67,2010,Aug,64.3,59.8,500825,465795,35030,7.0,MT
68,2010,Sep,64.2,59.7,500372,465321,35051,7.0,MT
69,2010,Oct,64.1,59.6,500038,464869,35169,7.0,MT
70,2010,Nov,64.0,59.5,499828,464588,35240,7.1,MT
71,2010,Dec,63.9,59.4,499719,464553,35166,7.0,MT
72,2011,Jan,63.9,59.4,499721,464781,34940,7.0,MT
73,2011,Feb,63.9,59.5,499700,465116,34584,6.9,MT
74,2011,Mar,63.8,59.5,499536,465377,34159,6.8,MT
75,2011,Apr,63.8,59.4,499306,465514,33792,6.8,MT
76,2011,May,63.7,59.4,499226,465635,33591,6.7,MT
77,2011,Jun,63.7,59.4,499502,465976,33526,6.7,MT
78,2011,Jul,63.8,59.5,500212,466749,33463,6.7,MT
79,2011,Aug,63.8,59.6,501247,467977,33270,6.6,MT
80,2011,Sep,63.9,59.7,502388,469513,32875,6.5,MT
81,2011,Oct,64.0,59.9,503378,471088,32290,6.4,MT
82,2011,Nov,64.0,60.0,503969,472384,31585,6.3,MT
83,2011,Dec,64.0,60.1,504138,473258,30880,6.1,MT
84,2012,Jan,64.0,60.1,504102,473787,30315,6.0,MT
85,2012,Feb,63.9,60.1,504157,474178,29979,5.9,MT
86,2012,Mar,63.9,60.1,504449,474559,29890,5.9,MT
87,2012,Apr,64.0,60.2,504942,474995,29947,5.9,MT
88,2012,May,64.0,60.2,505634,475624,30010,5.9,MT
89,2012,Jun,64.1,60.3,506446,476486,29960,5.9,MT
90,2012,Jul,64.1,60.4,507185,477470,29715,5.9,MT
91,2012,Aug,64.1,60.4,507764,478438,29326,5.8,MT
92,2012,Sep,64.1,60.5,508244,479327,28917,5.7,MT
93,2012,Oct,64.1,60.5,508604,480064,28540,5.6,MT
94,2012,Nov,64.1,60.5,508875,480628,28247,5.6,MT
95,2012,Dec,64.0,60.5,509103,481061,28042,5.5,MT
96,2013,Jan,64.0,60.5,509349,481423,27926,5.5,MT
97,2013,Feb,64.0,60.5,509687,481801,27886,5.5,MT
98,2013,Mar,64.0,60.5,510119,482245,27874,5.5,MT
99,2013,Apr,64.0,60.5,510594,482766,27828,5.5,MT
100,2013,May,64.0,60.5,510966,483222,27744,5.4,MT
101,2013,Jun,64.0,60.5,511208,483568,27640,5.4,MT
102,2013,Jul,64.0,60.5,511458,483921,27537,5.4,MT
103,2013,Aug,63.9,60.5,511695,484345,27350,5.3,MT
104,2013,Sep,63.9,60.5,511880,484863,27017,5.3,MT
105,2013,Oct,63.9,60.5,512116,485480,26636,5.2,MT
106,2013,Nov,63.9,60.6,512380,486132,26248,5.1,MT
107,2013,Dec,63.8,60.6,512516,486660,25856,5.0,MT
108,2014,Jan,63.8,60.6,512421,486983,25438,5.0,MT
109,2014,Feb,63.7,60.6,512169,487185,24984,4.9,MT
110,2014,Mar,63.6,60.6,511966,487393,24573,4.8,MT
111,2014,Apr,63.6,60.6,511934,487669,24265,4.7,MT
112,2014,May,63.6,60.6,512134,488112,24022,4.7,MT
113,2014,Jun,63.6,60.6,512539,488704,23835,4.7,MT
114,2014,Jul,63.5,60.6,512909,489212,23697,4.6,MT
115,2014,Aug,63.5,60.6,513167,489580,23587,4.6,MT
116,2014,Sep,63.5,60.6,513367,489884,23483,4.6,MT
117,2014,Oct,63.4,60.6,513525,490239,23286,4.5,MT
118,2014,Nov,63.4,60.6,513751,490786,22965,4.5,MT
119,2014,Dec,63.4,60.6,514253,491643,22610,4.4,MT
120,2015,Jan,63.5,60.7,515033,492735,22298,4.3,MT
121,2015,Feb,63.6,60.8,515924,493824,22100,4.3,MT
122,2015,Mar,63.6,60.9,516734,494730,22004,4.3,MT
123,2015,Apr,63.6,60.9,517282,495305,21977,4.2,MT
124,2015,May,63.6,60.9,517493,495499,21994,4.3,MT
125,2015,Jun,63.6,60.9,517470,495452,22018,4.3,MT
126,2015,Jul,63.5,60.8,517499,495460,22039,4.3,MT
127,2015,Aug,63.5,60.8,517775,495684,22091,4.3,MT
128,2015,Sep,63.5,60.8,518275,496124,22151,4.3,MT
129,2015,Oct,63.5,60.8,519031,496790,22241,4.3,MT
130,2015,Nov,63.6,60.8,519981,497588,22393,4.3,MT
131,2015,Dec,63.6,60.8,520883,498325,22558,4.3,MT
132,2016,Jan,63.6,60.9,521545,498852,22693,4.4,MT
133,2016,Feb,63.6,60.8,521898,499113,22785,4.4,MT
134,2016,Mar,63.6,60.8,521936,499124,22812,4.4,MT
135,2016,Apr,63.5,60.7,521820,499039,22781,4.4,MT
136,2016,May,63.4,60.7,521715,498984,22731,4.4,MT
137,2016,Jun,63.4,60.6,521652,499016,22636,4.3,MT
138,2016,Jul,63.3,60.6,521634,499140,22494,4.3,MT
139,2016,Aug,63.2,60.5,521668,499311,22357,4.3,MT
140,2016,Sep,63.2,60.5,521755,499476,22279,4.3,MT
141,2016,Oct,63.1,60.4,521828,499594,22234,4.3,MT
142,2016,Nov,63.0,60.4,521938,499776,22162,4.2,MT
143,2016,Dec,63.0,60.3,522219,500168,22051,4.2,MT
144,2017,Jan,63.1,60.5,525223,503357,21866,4.2,MT
145,2017,Feb,63.2,60.6,526050,504359,21691,4.1,MT
146,2017,Mar,63.2,60.6,527001,505437,21564,4.1,MT
147,2017,Apr,63.3,60.7,527966,506451,21515,4.1,MT
148,2017,May,63.3,60.7,528803,507282,21521,4.1,MT
149,2017,Jun,63.3,60.7,529395,507800,21595,4.1,MT
150,2017,Jul,63.3,60.7,529710,507986,21724,4.1,MT
151,2017,Aug,63.2,60.6,529722,507933,21789,4.1,MT
152,2017,Sep,63.1,60.5,529534,507771,21763,4.1,MT
153,2017,Oct,63.0,60.5,529329,507693,21636,4.1,MT
154,2017,Nov,63.0,60.4,529187,507763,21424,4.0,MT
155,2017,Dec,62.9,60.4,529223,508109,21114,4.0,MT
156,2018,Jan,62.9,60.5,529615,508842,20773,3.9,MT
157,2018,Feb,63.0,60.6,530473,509993,20480,3.9,MT
158,2018,Mar,63.1,60.7,531671,511405,20266,3.8,MT
159,2018,Apr,63.2,60.8,532844,512723,20121,3.8,MT
160,2018,May,63.2,60.8,533705,513664,20041,3.8,MT
161,2018,Jun,63.2,60.9,534186,514200,19986,3.7,MT
162,2018,Jul,63.2,60.8,534382,514473,19909,3.7,MT
163,2018,Aug,63.1,60.8,534572,514724,19848,3.7,MT
164,2018,Sep,63.1,60.8,534927,515126,19801,3.7,MT
165,2018,Oct,63.1,60.8,535452,515717,19735,3.7,MT
166,2018,Nov,63.1,60.8,536094,516462,19632,3.7,MT
167,2018,Dec,63.2,60.9,536803,517322,19481,3.6,MT
168,2019,Jan,63.2,60.9,537437,518142,19295,3.6,MT
169,2019,Feb,63.2,61.0,537942,518858,19084,3.5,MT
170,2019,Mar,63.2,61.0,538464,519535,18929,3.5,MT
171,2019,Apr,63.3,61.1,539220,520345,18875,3.5,MT
172,2019,May,63.3,61.1,540275,521328,18947,3.5,MT
173,2019,Jun,63.4,61.2,541555,522417,19138,3.5,MT
174,2019,Jul,63.5,61.3,542856,523462,19394,3.6,MT
175,2019,Aug,63.6,61.3,544026,524390,19636,3.6,MT
176,2019,Sep,63.6,61.3,545174,525412,19762,3.6,MT
177,2019,Oct,63.7,61.4,546411,526525,19886,3.6,MT
178,2019,Nov,63.8,61.4,547615,527536,20079,3.7,MT
179,2019,Dec,63.8,61.4,548286,527997,20289,3.7,MT
180,2020,Jan,63.7,61.3,548116,527768,20348,3.7,MT
181,2020,Feb,63.5,61.2,547094,526974,20120,3.7,MT
182,2020,Mar,63.3,61.0,545419,525909,19510,3.6,MT
183,2020,Apr,62.5,54.9,538905,473396,65509,12.2,MT
184,2020,May,62.7,57.0,541722,492200,49522,9.1,MT
185,2020,Jun,62.4,57.8,539344,499270,40074,7.4,MT
186,2020,Jul,62.5,58.5,540945,506033,34912,6.5,MT
187,2020,Aug,62.4,59.0,540809,511469,29340,5.4,MT
188,2020,Sep,62.5,59.4,542758,515611,27147,5.0,MT
189,2020,Oct,62.4,59.6,542290,518070,24220,4.5,MT
190,2020,Nov,62.2,59.6,542240,519562,22678,4.2,MT
191,2020,Dec,62.2,59.7,542452,520688,21764,4.0,MT
192,2021,Jan,62.1,59.7,542480,521933,20547,3.8,MT
193,2021,Feb,62.1,59.8,543537,523465,20072,3.7,MT
194,2021,Mar,62.2,59.9,545192,525344,19848,3.6,MT
195,2021,Apr,62.3,60.1,547197,527269,19928,3.6,MT
196,2021,May,62.4,60.1,548768,528864,19904,3.6,MT
197,2021,Jun,62.4,60.2,550043,530053,19990,3.6,MT
198,2021,Jul,62.4,60.2,550983,531435,19548,3.5,MT
199,2021,Aug,62.4,60.3,551821,533096,18725,3.4,MT
200,2021,Sep,62.4,60.4,552715,535112,17603,3.2,MT
201,2021,Oct,62.3,60.5,553662,536983,16679,3.0,MT
202,2021,Nov,62.2,60.4,553911,537626,16285,2.9,MT
203,2021,Dec,62.1,60.3,553871,537676,16195,2.9,MT
204,2022,Jan,62.1,60.4,555054,539835,15219,2.7,MT
205,2022,Feb,62.2,60.6,556361,542093,14268,2.6,MT
206,2022,Mar,62.3,60.8,558438,545341,13097,2.3,MT
207,2022,Apr,62.4,61.0,560660,547530,13130,2.3,MT
208,2022,May,62.5,61.0,562748,549017,13731,2.4,MT
209,2022,Jun,62.6,61.0,564538,550120,14418,2.6,MT
210,2022,Jul,62.6,61.0,565913,550795,15118,2.7,MT
211,2022,Aug,62.7,60.9,567249,551381,15868,2.8,MT
212,2022,Sep,62.6,60.8,568014,551609,16405,2.9,MT
213,2022,Oct,62.5,60.6,568135,551238,16897,3.0,MT
214,2022,Nov,62.4,60.6,568158,551709,16449,2.9,MT
